버스정류장ARS번호,역명,승차총승객수,하차총승객수,총이용객수,위도,경도
00000,판교IC,94,35,129,,
01001,종로2가사거리,706,565,1271,37.5698055407,126.9877522923
01002,창경궁.서울대학교병원,2925,2584,5509,37.579432932,126.9965206101
01003,명륜3가.성대입구,3766,3064,6830,37.5825800121,126.9982508372
01004,종로2가.삼일교,908,1067,1975,37.5685792736,126.9876130976
01005,혜화동로터리.여운형활동터,1803,2504,4307,37.586243,127.001744
01006,서대문역사거리,2294,1267,3561,37.566137,126.966893
01007,서울역사박물관.경희궁앞,4405,4545,8950,37.569135,126.97038
01008,서울역사박물관.경희궁앞,2950,2264,5214,37.5695119837,126.9707589959
01009,광화문역,4162,3990,8152,37.5701416811,126.9763534416
01010,광화문역,3665,3916,7581,37.5702396638,126.9778802991
01011,종로1가,4939,4891,9830,37.5701482455,126.9810660928
01012,종로1가,4717,4446,9163,37.5702710116,126.9816283242
01013,종로2가,4820,4194,9014,37.5701723774,126.9849902588
01014,종로2가,6112,4967,11079,37.5702378859,126.9865353674
01015,종로3가.탑골공원,4978,3190,8168,37.5702088889,126.9893256464
01016,종로3가.탑골공원,3531,4649,8180,37.5703605443,126.9899877751
01017,종로4가.종묘,1968,1822,3790,37.5705069968,126.9947218896
01018,종로4가.종묘,1444,2883,4327,37.570635002,126.995395739
01019,종로5가.광장시장,3926,3922,7848,37.5707860047,126.9990604685
01020,종로5가.광장시장,2369,2338,4707,37.570930167,126.9996038113
01021,종로6가.동대문종합시장,3269,1934,5203,37.5710111729,127.004462788
01022,종로6가.동대문종합시장,2405,3289,5694,37.5711272339,127.0057137364
01023,동대문역.흥인지문,5994,4955,10949,37.572447536,127.013815948
01037,동대문역.흥인지문,3478,4496,7974,37.5721053097,127.0124518417
01041,동묘앞.서울혜화경찰서,2209,1755,3964,37.5738321574,127.0186102731
01044,동묘앞.서울혜화경찰서,3410,3353,6763,37.5742464626,127.0195527812
01101,경기상고,680,306,986,37.5875502159,126.9693634554
01102,신교동,1683,470,2153,37.5832955233,126.9702626865
01103,경기상고,287,601,888,37.5871907861,126.9697701102
01104,경복고교,492,257,749,37.5851600316,126.9708802468
01105,청운중학교,83,262,345,37.587810579,126.9726741314
01106,자하문고개.윤동주문학관,342,99,441,37.5921866176,126.9671261805
01107,자하문고개.윤동주문학관,69,369,438,37.5923353152,126.9671906625
01108,청운중학교,217,163,380,37.5884219586,126.9722631304
01109,경복고교,306,414,720,37.5850633028,126.9714039185
01110,통인시장종로구보건소,1256,1262,2518,37.5803257033,126.9710500404
01111,통인시장종로구보건소,479,1262,1741,37.5805132118,126.9713851083
01112,효자동,402,1279,1681,37.583091043,126.9706209712
01113,사직단.어린이도서관,1166,629,1795,37.5751355316,126.9679907155
01114,경복궁역1번출구,3315,1735,5050,37.5761614873,126.9714158133
01115,경복궁역2번출구,1392,4179,5571,37.577040144,126.9721994292
01116,경복궁역3번출구,3847,1573,5420,37.5776713863,126.9722828893
01117,경복궁,1237,1814,3051,37.5755767894,126.9787471496
01118,광화문역2번출구.KT광화문지사,5443,1728,7171,37.5723209262,126.9774162769
01119,영추문,159,184,343,37.5789303855,126.9739817664
01120,광화문역6번출구,1341,1011,2352,37.5700448348,126.97640724
01123,서울역사박물관.강북삼성병원,1137,1331,2468,37.570023,126.971248
01124,새문안교회,204,470,674,37.5703368912,126.9728386477
01125,광화문역7번출구,226,60,286,37.570365,126.975837
01126,세종문화회관,2068,3365,5433,37.5736489318,126.9769975778
01127,서울경찰청.경복궁역,1504,2876,4380,37.5757446636,126.9714842989
01128,사직단,717,2029,2746,37.5748553458,126.968188961
01129,광화문역6번출구.광화문빌딩,262,367,629,37.5695035518,126.9768637419
01130,덕성여중고,1506,1301,2807,37.5757693863,126.981972246
01131,안국역.서울공예박물관,988,1068,2056,37.5760695565,126.9839957858
01132,국민은행세검정지점,391,290,681,37.6046629766,126.9608880061
01133,세검정초등학교,1399,649,2048,37.6025022799,126.9612198463
01134,세검정.상명대,387,154,541,37.6004770909,126.9582921267
01135,상명대입구.석파랑,169,109,278,37.5994133537,126.958570225
01136,하림각,730,369,1099,37.5981330665,126.9617068235
01137,자하문터널입구.석파정,646,272,918,37.5955935123,126.9636434993
01138,부암동주민센터.무계원,350,203,553,37.5927670827,126.9642221989
01139,부암동주민센터.무계원,177,424,601,37.5927861733,126.9651419211
01140,자하문터널입구.석파정,316,658,974,37.5955575712,126.9639775924
01141,하림각,417,624,1041,37.5981476478,126.962215308
01142,상명대입구.세검정교회,176,372,548,37.5996163318,126.9592405649
01143,세검정.상명대,310,376,686,37.6006470965,126.959155798
01144,세검정초등학교,1090,1367,2457,37.6022680671,126.9614328894
01146,국민은행세검정지점,341,614,955,37.6048461618,126.9611926889
01148,승가사입구,33,9,42,37.6115844138,126.9563059978
01149,구기동현대빌라,206,24,230,37.6100355035,126.9564575503
01150,구기터널.삼성출판박물관,386,155,541,37.6086098941,126.9562103294
01151,구기터널.삼성출판박물관,227,304,531,37.6083054034,126.9564166508
01152,구기동,1080,370,1450,37.6069644475,126.9585297928
01153,구기동,478,709,1187,37.6070088003,126.9591017479
01154,승가사입구,20,128,148,37.61148,126.956482
01155,갑을씨티텔앞,306,269,575,37.6043709709,126.9635350292
01156,평창파출소,1359,340,1699,37.6053223656,126.9660432906
01157,평창동주민센터,1378,430,1808,37.6066073749,126.9695663093
01158,일성아파트,519,214,733,37.6088723554,126.9729237379
01159,롯데아파트,728,338,1066,37.6103897208,126.9763156152
01160,롯데아파트,254,541,795,37.610248,126.976652
01161,벽산평창힐스아파트,125,452,577,37.60819,126.972797
01162,예능교회,345,514,859,37.606517,126.97
01163,서울예술고등학교.평창동주민센터,278,1068,1346,37.6057787606,126.9676276108
01164,화정박물관,205,944,1149,37.6045038178,126.9648102665
01165,강북삼성병원.경교장,98,172,270,37.568145927,126.9686004828
01167,독립문역.서대문형무소역사관,540,624,1164,37.573395,126.959322
01168,금화초등학교.서울시교육청,846,777,1623,37.5682538056,126.9645273358
01169,서대문역사거리.적십자병원,2053,1107,3160,37.5671081521,126.9675878497
01171,독립문,421,218,639,37.5713430165,126.9614303112
01172,창덕궁.우리소리박물관,1758,2720,4478,37.5775405746,126.9885394479
01173,서린동.SK서린빌딩,346,272,618,37.5692639006,126.9800947893
01174,청계1가.광교,68,81,149,37.568684389,126.9849267193
01175,청계2가.수표교,67,75,142,37.5684453156,126.9908172161
01176,청계4가.세운교,25,25,50,37.5689254028,126.9965617399
01177,청계5가.광장시장,72,118,190,37.5694512793,126.9997973605
01198,원남동,2530,2201,4731,37.5745325055,126.9973383362
01199,창덕궁.우리소리박물관,2268,1441,3709,37.5772726542,126.9889538872
01200,안국역6번출구.인사동문화의거리,3730,2065,5795,37.575798979,126.9841344381
01201,조계사.종로경찰서,1820,1357,3177,37.5725223095,126.9831555803
01202,조계사.종로경찰서,1549,1907,3456,37.5724858087,126.9828258888
01203,안국동사거리,433,681,1114,37.5746105669,126.9827201116
01204,효제동.김상옥의거터,561,941,1502,37.5745,127.00223
01205,종로5가.효제초등학교,1579,1094,2673,37.5728790133,127.0021442279
01209,창덕궁.서울돈화문국악당,105,141,246,37.5774327721,126.991234977
01212,종로5가역6번출구,729,700,1429,37.5705596025,127.0021826522
01213,청계5가.마전교,79,75,154,37.5698351103,127.0028494203
01214,동대문,586,646,1232,37.5717262368,127.0084126252
01215,충신동,538,512,1050,37.5740223509,127.006278812
01217,충신동,220,572,792,37.5744602778,127.0063433807
01218,현대그룹빌딩,942,1166,2108,37.5759104142,127.0008065808
01219,방송통신대.이화장,2502,2958,5460,37.578043,127.002437
01220,혜화역2번출구.마로니에공원,3146,3634,6780,37.5811194873,127.0022769364
01221,혜화역3번출구.서울대병원입구,3864,1319,5183,37.5809559696,127.0018481852
01222,방송통신대.이화장,709,590,1299,37.5777889737,127.0019782952
01223,현대그룹빌딩,1340,698,2038,37.576119355,127.0006951494
01224,창경궁.서울대학교병원,1152,1739,2891,37.5788279947,126.9968717143
01225,이화동,454,394,848,37.5759372914,127.0032708172
01226,혜화동로터리,469,426,895,37.5855803307,127.0006878052
01227,명륜동2가.성균관대입구,1473,1817,3290,37.5834170764,126.9993412723
01228,혜화역.서울연극센터,1049,1250,2299,37.5840306853,127.0014608831
01229,혜화역.동성중고,3238,1862,5100,37.5845329425,127.0015561579
01231,종로구민회관.창신동두산아파트,442,657,1099,37.5740926792,127.0155555279
01235,동묘앞역6번출구,235,286,521,37.5716849566,127.0156014431
01236,동묘앞역5번출구,167,201,368,37.5719221488,127.0159450485
01238,창신3동주민센터,340,413,753,37.578413,127.015178
01239,숭인1동주민센터.창신역4번출구,1220,538,1758,37.5786281555,127.0154557816
01240,동묘앞역.롯데캐슬천지인,2161,626,2787,37.5741800523,127.0158023517
01243,신설동역오거리,1042,2187,3229,37.5756947252,127.0228414296
01245,동묘앞역2번출구,160,187,347,37.5736431148,127.0175234975
01246,구기동현대빌라,57,315,372,37.609682,126.956622
01247,광장시장,640,922,1562,37.5694963125,126.9977437946
01249,서울특별시재향군인회관,253,300,553,37.5725807445,126.9974787875
01250,서울역사박물관,211,415,626,37.5699003386,126.9721318077
01251,청계3가.관수교,22,54,76,37.5686887917,126.9937793705
01252,청계6가.버들다리,203,195,398,37.5699303868,127.0080377075
01253,청계7가.맑은내다리,176,146,322,37.5700419608,127.0130967122
01254,청계8가.영도교,132,107,239,37.5708949889,127.0181256262
01256,원남동사거리,310,710,1020,37.5757617378,126.9981123217
01262,숭인2동주민센터,608,570,1178,37.5742721533,127.0204373408
01267,조계사,124,607,731,37.572800338,126.9831609226
01272,세종문화회관,554,396,950,37.5733655664,126.9770167126
01277,이화동,118,659,777,37.576257,127.002955
01278,상명대정문,887,1161,2048,37.601417,126.955143
01279,이북오도청,215,226,441,37.6127234824,126.9559729686
01280,효자로입구,4,0,4,37.576709505,126.9743023448
01286,상명대입구.세검정교회,93,223,316,37.5994435122,126.9597921957
01287,상명대입구.석파랑,447,238,685,37.5995718125,126.9581941404
01288,종로중부새마을금고,626,727,1353,37.5724174899,127.0065911394
01289,신설동역오거리.서울풍물시장,612,364,976,37.5742548131,127.0231950517
01291,청계2가.삼일교,70,150,220,37.5683454305,126.9869890809
01292,청계8가.황학교,213,120,333,37.5721307298,127.0227870051
01293,평창동삼성아파트,144,353,497,37.6111800895,126.9787981475
01294,안국역5번출구,229,459,688,37.5763329308,126.9855365486
01295,안국역.서울공예박물관,846,1258,2104,37.5764140065,126.9848871214
01297,남인사마당,182,154,336,37.5713191723,126.9874286375
01500,평창파출소,348,58,406,37.605681218,126.9668167021
01501,삼청공원,244,119,363,37.5882276807,126.9816468946
01502,수성동계곡,403,423,826,37.5820813834,126.9644678921
01503,명륜3가종점,259,360,619,37.5909483783,126.9928636796
01504,명륜새마을금고,61,5,66,37.5877854691,126.9967901477
01505,서대문역3번출구,1460,442,1902,37.5663370645,126.9663939394
01506,낙산공원,139,272,411,37.5804037213,127.0087215681
01507,세탁소,79,136,215,37.5814109836,126.9893670844
01508,화정박물관,13,1,14,37.6048011982,126.9648837454
01509,금융연수원,305,0,305,37.5866398268,126.9816582681
01510,박노수미술관,547,1,548,37.5809967425,126.966603478
01511,샘미용실.종로구청소년상담복지센터,176,0,176,37.5903095275,126.9932227051
01512,서울국제고등학교,400,29,429,37.5890715947,126.9972902593
01513,화정박물관,52,6,58,37.6049806084,126.9652007897
01514,적십자병원후문앞,23,6,29,37.5675295356,126.9652272769
01515,서울성곽.성대후문,21,0,21,37.5893663808,126.989569366
01516,빨래터,69,88,157,37.582987218,126.9890634276
01517,세검초등학교,8,4,12,37.6042522792,126.9614907597
01518,삼청동주민센터,332,6,338,37.5842638281,126.9819071619
01519,통인시장앞,248,10,258,37.5804417494,126.9684956941
01520,양현관,223,1,224,37.5897914226,126.9936043615
01521,국민생활관,869,73,942,37.5897456349,126.9988619666
01522,오거리,1,30,31,37.6070621164,126.9622629001
01523,경희궁자이2.3단지,66,49,115,37.5687871134,126.9640686009
01524,창신쌍용2단지.한성대후문,518,6,524,37.5812647965,127.0127581151
01525,통일부,43,2,45,37.5875948053,126.9859476734
01526,원서고개,102,169,271,37.583080553,126.9878088426
01528,종로5가입구,83,74,157,37.5717928476,126.9976709493
01529,삼청파출소,228,15,243,37.581813662,126.9812510491
01530,오거리.한옥마을입구,79,9,88,37.579404615,126.9696088803
01531,명륜시장.성대후문,684,14,698,37.5885110529,126.9952543092
01532,혜화초등학교,336,179,515,37.5872532276,126.9998516643
01533,청련사입구,2,45,47,37.6079803769,126.9624312007
01534,영천시장,314,180,494,37.5700818569,126.9627388724
01535,명신초.삼선푸르지오.힐스테이트,275,3,278,37.5821062067,127.014556281
01536,감사원,415,11,426,37.5862106518,126.9852900569
01537,중앙중고,128,124,252,37.583092177,126.986965299
01538,인왕빌딩,8,1,9,37.6079283311,126.9577443332
01539,종로4가.종묘공원,199,109,308,37.5706890289,126.9946203403
01540,국립민속박물관,274,45,319,37.5792551846,126.9795533717
01541,광화문새마을금고,38,90,128,37.5793687689,126.9711466491
01542,새마을금고,402,18,420,37.5877370613,126.996518051
01543,혜화우체국,207,528,735,37.5860376565,127.0006137149
01544,언덕앞,4,31,35,37.6089539753,126.9637921715
01545,경희궁자이4단지,169,183,352,37.5707022242,126.9621148375
01546,종로센트레빌후문.e편한세상보문아파트,104,8,112,37.5817743934,127.0161855253
01547,사우디대사관앞.경남빌라,100,2,102,37.5841056738,126.9850311776
01548,안국선원.삼거리,177,38,215,37.5827909789,126.984994076
01549,구기터널입구,33,10,43,37.6082046142,126.9567768927
01550,종로3가역9번출구,1039,603,1642,37.5710875771,126.9920931881
01551,경복궁,119,107,226,37.576950157,126.9793377561
01553,소나무집,6,52,58,37.6112770717,126.964110466
01554,독립문역3번출구,490,257,747,37.5728784775,126.9597453483
01555,청룡사.보문파크뷰자이아파트,226,20,246,37.5800189539,127.01700714
01556,북촌한옥마을입구.정세권활동터,381,34,415,37.5815997311,126.9849422317
01557,종로1.2.3.4가동주민센터,156,119,275,37.5743837122,126.9911314256
01558,창덕궁,23,100,123,37.5760892484,126.9906200153
01561,아름다운실버,0,10,10,37.6120100581,126.965463701
01562,독립문초등학교,51,109,160,37.5738699714,126.9606775165
01563,종로센트레빌아파트,121,85,206,37.5803534405,127.0156926979
01564,가회동주민센터,111,45,156,37.579972942,126.9849543284
01565,문방구,2,1,3,37.6062686142,126.9579797248
01566,원남로터리,52,118,170,37.5762373738,126.997511497
01567,보현산신각,3,20,23,37.6134825236,126.9657790521
01568,린덴바움숲유치원,97,302,399,37.5746692802,126.9618040443
01569,쌍용아파트입구.창신역,142,191,333,37.580511226,127.0149635738
01570,아름다운가게.정독도서관,181,158,339,37.5789480833,126.9851271782
01571,산정빌라,3,11,14,37.6051519935,126.9574922002
01572,이화사거리,98,469,567,37.5765095598,127.0020914666
01573,박종화고택입구,2,16,18,37.6143102577,126.9676873462
01574,무악현대아파트후문,112,318,430,37.5763372261,126.9619411637
01576,헌법재판소.안국역,125,503,628,37.5773871956,126.9858152185
01577,청구빌라,9,87,96,37.6046102563,126.9569839726
01578,서울대어린이병원응급실.갑상선센터,11,427,438,37.5781188768,126.9995029662
01580,화인빌라,11,28,39,37.6129345305,126.9685386165
01581,행촌주차장,88,286,374,37.5752728058,126.9628880463
01582,창신초등학교,211,100,311,37.5769032044,127.0153885503
01583,수운회관,46,99,145,37.5752189424,126.986669266
01584,상명대후문,54,102,156,37.6040255786,126.9573354115
01586,힐탑,4,22,26,37.6116055569,126.9690205751
01587,성결교신대원총회본부,7,77,84,37.5739763092,126.9634445669
01589,낙원상가,87,285,372,37.5737563689,126.9874148722
01590,완성빌라,20,48,68,37.6034020863,126.9575011241
01591,서울대병원장례식장,30,52,82,37.5805553988,126.9974309648
01592,혜화역1번출구,1539,194,1733,37.5834729904,127.0017632862
01593,감나무골공원,0,6,6,37.6124059606,126.9699479367
01594,한국사회과학도서관.이회영기념관,71,281,352,37.5736670147,126.9641239308
01595,동묘앞역8번출구,134,285,419,37.5726943506,127.0142453819
01596,종로2가.탑골공원,278,461,739,37.5705713654,126.9875484137
01597,경진빌라,3,6,9,37.6020037175,126.9578303612
01598,성대입구,17,142,159,37.5833533096,126.9992849459
01601,청와대,162,144,306,37.5829712951,126.973768082
01602,춘추문,136,220,356,37.5831276121,126.9796554436
01603,경복궁.국립민속박물관,458,188,646,37.5794135204,126.9795911351
01607,EN갤러리,2,13,15,37.6134217965,126.9706087294
01612,유림회관앞,4,5,9,37.5858955968,126.9969805237
01615,성균관대정문,37,127,164,37.5849563466,126.9966204422
01616,600주년기념관,6,425,431,37.5873281035,126.9939426439
01617,성균관대운동장,286,478,764,37.587863,126.99237
01618,학생회관,227,6,233,37.5874203934,126.9936746328
01667,종로문화체육센터,131,119,250,37.5746935562,126.9645321424
01682,동대문역.2번출구,162,409,571,37.5720494465,127.0117218002
01683,종각역YMCA,555,406,961,37.5703976388,126.98508926
01684,서교빌라,6,21,27,37.601989057,126.9571553655
01685,경복궁역,527,194,721,37.5770722054,126.9724733176
01697,성대입구,188,43,231,37.5832668015,126.998853007
01698,무애사,4,5,9,37.6139004282,126.9718458037
01699,단군성전앞,8,17,25,37.5755600915,126.9653175119
01702,동대문종합시장,174,233,407,37.5712161296,127.004958038
01714,상명초등학교,5,16,21,37.6009238115,126.956715418
01720,법련사,169,386,555,37.5765879752,126.9796650539
01721,광화문새마을금고,39,126,165,37.5794930902,126.9710277184
01722,성균관대정문,53,17,70,37.584886,126.996646
01723,참샘골공원,7,23,30,37.6146097003,126.9742524976
01724,황학정앞,17,43,60,37.5768126115,126.9653293849
01725,종로5가역.중부교육지원청,1207,433,1640,37.5714192458,127.0020898456
01727,인사동들머리.3.1독립선언터,27,8,35,37.5719470235,126.983296967
01728,정독도서관,18,571,589,37.5802605382,126.980080541
01729,오거리.한옥마을입구,9,129,138,37.5794684375,126.9697392663
01732,평창공원지킴터입구,2,8,10,37.6163963984,126.9757438761
01763,종로1가,1060,550,1610,37.57037,126.980129
01776,종로도서관,93,78,171,37.5764842271,126.9671251598
01790,종로사우나,264,42,306,37.5738011149,126.9877503526
01791,홍지파크,1,1,2,37.6012424257,126.9557163281
01792,삼청파출소,16,222,238,37.58164517,126.9813258198
01793,통인시장.종로구보건소,39,415,454,37.5803350289,126.9687504797
01794,종로5가역.광장시장,610,565,1175,37.5707724724,127.000038992
01795,평창동산림제3초소,8,11,19,37.6173560499,126.9771030504
01796,배화여중고.매동초교,97,234,331,37.5767787564,126.9676986337
01797,대학로입구.이화사거리,571,375,946,37.5759841652,127.0025801998
01798,운현궁,12,0,12,37.5752716136,126.9869813803
01799,상명대입구,2,10,12,37.6000210109,126.9569583018
01800,삼청동주민센터,9,301,310,37.5846846831,126.9822105151
01801,박노수미술관,4,395,399,37.5810265604,126.9668944502
01802,김창열.윤명로화실,8,9,17,37.616304998,126.9783685436
01803,사직공원.경복궁역입구,260,258,518,37.5762206893,126.9689039095
01804,충신시장,305,188,493,37.5749766498,127.005404874
01805,안국역2번출구앞,1143,174,1317,37.5771728174,126.9861183272
01807,금융연수원,2,270,272,37.5858776706,126.981847891
01809,감람산기도원,8,3,11,37.6159439291,126.9798729651
01810,카센터.사직터널앞,33,27,60,37.57409862,126.9658895166
01812,재동초등학교,50,219,269,37.578791085,126.9853617134
01814,삼청공원삼거리.옥호정터,1,137,138,37.5874185176,126.9817444742
01815,이화사거리,97,179,276,37.5753200672,127.0022812884
01816,연화정사,0,3,3,37.6146490046,126.9794938432
01817,대신중고,181,211,392,37.5726178078,126.9616893251
01819,현대사거리,14,46,60,37.5792417814,126.9866353642
01820,교남동주민센터,7,25,32,37.5721819807,126.9613278115
01821,부암동주민센터.무계원,20,29,49,37.5929353403,126.9637682263
01823,형제봉입구,2,3,5,37.6128643152,126.9816861503
01824,교남동새마을금고,90,118,208,37.5714943551,126.962337459
01825,창신초교,50,103,153,37.5760372123,127.0157200961
01826,가회동주민센터,21,157,178,37.5799426497,126.9851293823
01827,볼링장,19,56,75,37.5792554401,126.9879589184
01829,석파정.서울미술관,31,9,40,37.5947643228,126.9637824182
01830,지구촌교회,18,26,44,37.6131060324,126.9792421489
01831,월암공원,47,44,91,37.5712260916,126.9646918774
01832,숭인1동주민센터,114,117,231,37.5774150014,127.0155607478
01833,북촌한옥마을입구.정세권활동터,12,422,434,37.5812807738,126.9851687446
01835,하림각,28,1,29,37.5976847268,126.9629663842
01836,보현빌라,12,4,16,37.6153822583,126.9784205906
01837,스위스대사관,0,20,20,37.5701413179,126.9656960774
01839,안국선원.삼거리,3,235,238,37.5827432497,126.9852205387
01840,세검정교회,13,1,14,37.5993880238,126.9600291533
01841,혜화동로터리,459,272,731,37.5859196111,127.0010032298
01842,김종영미술관,12,9,21,37.6132637884,126.9781122953
01843,서울시교육청,73,90,163,37.569381682,126.9666998924
01844,창신쌍용1단지.종로센트레빌아파트,56,291,347,37.5803228198,127.0155692785
01845,사우디대사관.북촌힐스,4,171,175,37.583863308,126.9852486243
01846,상명대입구,74,1,75,37.5998544708,126.9574023475
01847,혜화초등학교,99,456,555,37.5873892922,126.9999909413
01849,강북삼성병원,13,200,213,37.5685315243,126.9683376852
01850,청룡사.보문파크뷰자이아파트,50,444,494,37.5797846496,127.0171508787
01851,감사원,11,534,545,37.5862656518,126.9855618026
01852,국민생활관,67,635,702,37.5896275957,126.9993137839
01855,종로센트레빌후문.e편한세상보문아파트,5,263,268,37.5818978359,127.0162353711
01856,통일부,0,29,29,37.5875308468,126.9861073451
01858,서울국제고등학교,8,399,407,37.5890742944,126.9971407875
01860,성대후문.와룡공원,0,47,47,37.5891522774,126.989734001
01861,상명초등학교,17,14,31,37.600904926,126.9568173576
01862,새마을금고,74,626,700,37.5878406881,126.9965690016
01863,경진빌라,5,19,24,37.6018640911,126.9579482257
01864,명륜시장.성대후문,19,604,623,37.5887246101,126.9952305162
01865,완성빌라,20,58,78,37.6033399708,126.9576665157
01866,양현관,2,218,220,37.5897680031,126.9937685575
01868,상명대후문,37,50,87,37.6040715802,126.9574633677
01869,샘미용실.종로구청소년상담복지센터,1,132,133,37.5902545716,126.9934084203
01870,산정빌라,3,3,6,37.6052835831,126.9575782035
01872,문방구,0,17,17,37.6061334517,126.9579809335
01873,마트앞,9,46,55,37.6066987064,126.958756466
01874,국민은행.세검정지점,4,7,11,37.6049541749,126.9608727063
01876,혜화역4번출구,369,2063,2432,37.5835080381,127.0015538872
01877,방송통신대앞,131,257,388,37.5786973612,127.0019926794
01878,서울대치과대학,3,107,110,37.5774082997,126.997800962
01879,효제초교.연동교회.김마리아활동터,187,206,393,37.5736413355,127.0022087811
01881,성균관대학교,109,216,325,37.5884638684,126.9900035953
01883,서울대치과대학,56,43,99,37.5775727323,126.9978632209
01886,이화사거리,88,129,217,37.5769483437,127.0020084833
01887,서울대학교병원현관.암병원현관,753,1661,2414,37.5790872846,126.9981631637
01888,공평.종각,373,105,478,37.5715937879,126.9832427053
01889,조계사,106,43,149,37.5736021088,126.9831364101
02001,남대문세무서,2589,2407,4996,37.5649848069,126.9875299251
02002,국가인권위.안중근활동터,4062,3094,7156,37.5643504711,126.9878515151
02003,서울역버스환승센터,429,1226,1655,37.5551460158,126.9722570849
02004,서울역버스환승센터,5085,5231,10316,37.5554029828,126.9725924801
02005,서울역버스환승센터,2786,3449,6235,37.555388989,126.9727238221
02006,서울역버스환승센터,4898,5817,10715,37.5554794133,126.9728547738
02007,서울역버스환승센터.강우규의거터,1866,2705,4571,37.5554141603,126.9729402621
02008,숭례문,2261,1891,4152,37.5586388574,126.9737783904
02099,숭례문,2,555,557,37.5597967723,126.9743556496
02101,만리동고개,1317,1063,2380,37.551787064,126.9626582054
02102,손기정체육공원입구,707,952,1659,37.5544459527,126.9662339013
02103,서울의료보건고등학교.서울역서부,1407,473,1880,37.5558478973,126.9689026242
02104,서울역서부,932,513,1445,37.556237644,126.9691514463
02105,서울역서부,912,1298,2210,37.555855,126.969293
02106,중림동교차로,444,551,995,37.5583836266,126.9691354395
02107,종근당.충정로역,946,729,1675,37.5596488763,126.9645407963
02108,한국경제신문사.서소문역사공원,468,546,1014,37.5602111497,126.9678680149
02109,한국경제신문사.서소문역사공원,551,518,1069,37.5606234736,126.9681135141
02110,경찰청.동북아역사재단,1220,1463,2683,37.5630494858,126.9691267228
02113,농협은행.유관순활동터,1260,302,1562,37.5649062803,126.9677868059
02116,염천교,940,516,1456,37.5598696316,126.97311408
02117,숭례문,148,56,204,37.5584010617,126.97335794
02118,숭례문.한국일보,905,462,1367,37.5587713091,126.9737375955
02120,후암삼거리,231,329,560,37.5534055956,126.9759937564
02121,숭례문,210,19,229,37.5587633765,126.974362745
02122,숭례문,1903,2106,4009,37.5584195299,126.9740436876
02123,숭례문,1471,383,1854,37.5580006528,126.9736279452
02124,남대문시장악세사리전문상가,155,1004,1159,37.5588723988,126.9759976615
02125,숭례문남산방향,813,93,906,37.5585581643,126.9756720863
02126,남대문시장.신세계앞,425,412,837,37.561191081,126.9800597585
02127,북창동.남대문시장,3829,2931,6760,37.561273,126.978555
02128,소공동주민센터,2183,3245,5428,37.562197167,126.97644367
02131,삼성본관앞,2088,1500,3588,37.5620517519,126.9759075283
02132,시청역8번출구,787,256,1043,37.562764205,126.976148714
02133,시청역9번출구.시청서소문2청사,1298,1083,2381,37.5631901447,126.9746522037
02134,서소문,1889,1422,3311,37.563722,126.975314
02135,시청.서소문청사,1120,526,1646,37.5635248407,126.9749539314
02137,서울신문사,2207,1833,4040,37.5683632936,126.9773647051
02139,우리은행종로지점,2670,2964,5634,37.5678390393,126.9828658628
02140,롯데백화점,5831,4649,10480,37.5645069796,126.9822069938
02141,해운센터.롯데영플라자,508,754,1262,37.5628907847,126.9815478394
02142,명동.롯데영프라자,5921,4674,10595,37.562885,126.982008
02144,신세계백화점,996,882,1878,37.561127344,126.9814315438
02145,남대문시장.회현역,1956,1306,3262,37.5582675237,126.9777650546
02146,남대문시장.회현역,1181,2081,3262,37.5584920257,126.9784645011
02147,남산3호터널,601,655,1256,37.5583104538,126.9827404025
02148,남산3호터널.정화예술대학교,838,1518,2356,37.5595260891,126.9826359346
02149,명동역4번출구,1622,1468,3090,37.560657849,126.9849157703
02150,퇴계로2가.명동역5번출구,634,584,1218,37.5609325805,126.9843582953
02151,충무로역.한옥마을.한국의집,1754,1014,2768,37.5612508237,126.9917771969
02152,충무로역.한옥마을.한국의집,684,725,1409,37.5609019668,126.9924098253
02153,충무로역2번출구,1772,840,2612,37.5612375854,126.9947285429
02154,충무로역8번출구,1051,1174,2225,37.5620371603,126.9964921507
02155,초동,116,134,250,37.5633461766,126.9931119513
02156,을지로입구.로얄호텔,1673,1159,2832,37.5658757422,126.9853902774
02157,을지로입구.시청입구,1431,1133,2564,37.5661382638,126.9811712097
02158,을지로2가.기업은행본점.서울노동청,2596,1747,4343,37.566246226,126.9865233528
02159,을지로2가.파인에비뉴,1840,508,2348,37.5660727123,126.988670826
02160,을지로3가,547,1314,1861,37.5663729806,126.9902600103
02161,을지로3가,879,557,1436,37.5661205237,126.9913276421
02162,을지로4가,426,887,1313,37.5666841559,126.9959336364
02163,을지로4가.베스트웨스턴국도,1158,933,2091,37.5664010399,126.9968473297
02164,중구청앞.덕수중학교,360,571,931,37.5647745951,126.9981401348
02165,방산시장.을지로4가역6번출구,351,557,908,37.5668182855,126.999258524
02166,을지로5가.중부시장,510,562,1072,37.5666200422,127.0011150411
02167,방산시장.훈련원종합체육관,209,338,547,37.5679608485,127.0024044565
02168,을지로5가,311,148,459,37.5658243542,127.0025945654
02169,을지로6가.국립중앙의료원,959,821,1780,37.5661698346,127.0062316194
02170,동대문역사문화공원역8번출구,2237,1061,3298,37.5650528273,127.0072096931
02171,동대문역사문화공원역9번출구,1028,2417,3445,37.5651725525,127.0077222561
02172,을지로6가.국립중앙의료원,585,730,1315,37.5664631128,127.0058434821
02173,동대문역사문화공원,2915,2566,5481,37.5673541422,127.0083555318
02174,동대문역사문화공원,3476,2606,6082,37.5674835037,127.0091685169
02177,충무아트센터.스포츠센터.중부소방서,1439,1226,2665,37.5651675256,127.0135231437
02178,충무아트센터.스포츠센터.중부소방서,979,1425,2404,37.5650178857,127.0147408667
02179,성동공업고등학교,619,531,1150,37.5683481924,127.0157558376
02180,성동공업고등학교앞,720,502,1222,37.5686950625,127.0161294881
02181,신당역1번출구.서울중앙시장,1077,1165,2242,37.5657282804,127.0187426545
02182,신당역4번출구.서울중앙시장,1959,1973,3932,37.5654920748,127.0194795301
02183,성동고등학교,2040,1486,3526,37.5655941894,127.0221821569
02184,성동고등학교,939,880,1819,37.5652410933,127.0223979004
02187,신당동떡볶이타운.중구여성플라자,1346,945,2291,37.5627954621,127.0150959791
02188,신당동떡볶이타운.중구여성플라자,932,1008,1940,37.5623100443,127.0151908517
02189,청구초등학교.청구역,577,894,1471,37.5589483023,127.0132161263
02190,장충초등학교.청구역,978,887,1865,37.559257398,127.0130316796
02191,약수역2번출구.가온도서관,657,1061,1718,37.5557929112,127.0110429415
02192,약수역3번출구.약수하이츠,1475,817,2292,37.5557496102,127.0113796895
02193,약수역4번출구.금호터널입구,371,650,1021,37.553399,127.012012
02194,약수역5번출구.금호터널입구,877,710,1587,37.55292373,127.0118693353
02195,약수역8번출구.신당사회복지관,1132,630,1762,37.5538646495,127.0099566945
02196,약수역7번출구.약수동주민센터,707,765,1472,37.5528509718,127.0092978444
02197,송도병원앞,329,501,830,37.5502676468,127.0077186988
02198,송도병원앞,306,461,767,37.550227118,127.0073984027
02199,약수역1번출구,429,356,785,37.556252533,127.009755648
02201,장충체육관앞,382,463,845,37.5583362176,127.0080610837
02202,장충체육관앞,322,487,809,37.5580017329,127.0078281581
02203,장충동.동국대입구,932,1040,1972,37.560621324,127.00590981
02204,장충동.동국대입구,719,936,1655,37.5606663921,127.0056290943
02205,퇴계로6가,322,466,788,37.5634011312,127.0039011095
02206,퇴계로6가.광희동주민센터,740,773,1513,37.5635284386,127.00337576
02207,퇴계로5가.충무초등학교,923,616,1539,37.5623804057,126.9999660413
02208,퇴계로5가.중구청,383,597,980,37.5627804223,126.9997252277
02209,국립극장.반얀트리호텔,550,296,846,37.551481823,127.001094708
02210,국립극장.반얀트리호텔,644,975,1619,37.5515339575,127.0007525635
02211,청구역2번출구,167,257,424,37.5599600605,127.014656108
02212,청구역3번출구,705,171,876,37.5599303778,127.014219181
02213,동화동,293,63,356,37.5600244709,127.018125822
02214,동화동,21,414,435,37.5598126778,127.0182736903
02215,백범광장,167,168,335,37.555737,126.980093
02218,남대문경찰서.서울역10번출구,131,601,732,37.554128189,126.9738404394
02219,남대문시장앞.이회영활동터,3447,3511,6958,37.5609394169,126.978580386
02220,남산케이블카.남산산책로입구,66,87,153,37.5552651842,126.9839798009
02222,동대입구역.장충동,875,243,1118,37.558362,127.005445
02223,약수역10번출구,134,282,416,37.556256,127.009322
02224,청계1가.광교,150,62,212,37.5685707852,126.9833922386
02225,청계2가.삼일교,202,59,261,37.5678404706,126.9885301722
02226,청계4가.배오개다리,64,44,108,37.5684843738,126.9971755363
02227,청계5가.방산시장,114,89,203,37.5692149555,127.0008265972
02228,청계6가.평화시장,47,75,122,37.5694411915,127.0043806283
02229,청계7가.동평화.청평화시장,520,352,872,37.5695135434,127.0138508174
02230,청계8가.영도교,154,369,523,37.5707259153,127.0189971981
02233,신한은행본점,273,267,540,37.5611965482,126.975585201
02234,퇴계로2가.명동역7번출구,1040,1639,2679,37.560988,126.985336
02235,광희동.동대문역사문화공원역,387,373,760,37.5654113309,127.0091092289
02236,버티고개,614,486,1100,37.5478041512,127.0060242348
02237,버티고개,486,745,1231,37.547650494,127.0061899379
02240,청계3가.관수교,110,54,164,37.5682134567,126.9929650755
02241,청계6가.오간수교,251,148,399,37.5694851752,127.0090361408
02242,충무로역7번출구,32,320,352,37.561690572,126.9933889105
02246,을지로입구역.광교,1264,2728,3992,37.5676492567,126.9825656304
02252,신당파인힐하나유보라,939,488,1427,37.5649809794,127.0248560363
02254,남산북측순환로입구,67,65,132,37.5506986166,126.9988218165
02255,신당동삼성아파트.금호여중,107,611,718,37.5585545048,127.0187298806
02256,신당동대우푸르지오.금호여중,166,60,226,37.5578078339,127.019288178
02257,황학동주민센터,222,274,496,37.5668556166,127.0234023516
02258,신당초등학교앞,482,244,726,37.5644813411,127.0239172657
02259,금호베스트빌.래미안하이베르,236,911,1147,37.5616452068,127.0240513307
02260,금호베스트빌.래미안하이베르,224,105,329,37.5622544456,127.0243472269
02261,신당초등학교,13,330,343,37.5645028357,127.024240415
02272,방산종합시장,180,220,400,37.5678058693,127.0019301271
02273,황학동롯데캐슬,328,407,735,37.5716601701,127.0220339686
02274,광희문.광희동사거리,279,395,674,37.5645499236,127.0086110484
02275,광희문.광희동사거리,222,280,502,37.5644016142,127.009677887
02277,황학동롯데캐슬,721,311,1032,37.5708197498,127.0232958633
02278,한국은행앞,158,46,204,37.561408112,126.9792899798
02279,서울기동대.광희초등학교,76,32,108,37.5679222068,127.0144829458
02280,동대문디자인플라자,76,82,158,37.567700749,127.0119962039
02281,서대문역사거리.농협중앙회,1291,2129,3420,37.5668848609,126.9679802656
02282,서울역9번출구.서울스퀘어빌딩앞,301,665,966,37.555341632,126.97323173
02284,힐튼호텔,239,245,484,37.5563677408,126.976567168
02285,힐튼호텔,84,609,693,37.5566267411,126.9767113404
02286,시청앞.덕수궁,1036,1829,2865,37.5662122834,126.9768355729
02288,장충문화체육센터.권기옥활동터,15,49,64,37.5601745008,127.0025921056
02289,남산1호터널,524,1313,1837,37.5574051765,126.9921666231
02291,남산예장버스환승주차장,920,860,1780,37.55974,126.989289
02501,약수역.3.6호선,458,324,782,37.553304657300004,127.011705637
02502,조선일보,83,442,525,37.5687339805,126.976883066
02503,시청역,133,687,820,37.566031,126.97701
02505,서울역,231,175,406,37.5582012576,126.9713291252
02506,숭례문앞,425,92,517,37.5615164368,126.976236105
02507,프레스센터,1075,318,1393,37.5673960903,126.977339075
02510,신당역하나은행,2263,1304,3567,37.5654231103,127.0215878668
02513,염천교,5,61,66,37.5597925744,126.9711136524
02516,한국경제신문사,43,89,132,37.5609334062,126.9679526472
02518,응봉근린공원.금호산,18,50,68,37.5535217011,127.0169189818
02519,서울방송고등학교.남산타운아파트,151,162,313,37.5495860191,127.012409789
02520,서울방송고등학교.남산타운아파트,99,878,977,37.5496119425,127.0122783521
02521,중구청소년센터.남산타운2상가,1,26,27,37.5516549062,127.012751162
02522,중구청소년센터.남산타운2상가,39,30,69,37.5519027425,127.0121655599
02523,약수시장.남산타운동문,145,101,246,37.5517332168,127.0108500123
02524,약수지구대,1014,197,1211,37.5528410964,127.0119577646
02641,서울광장,522,367,889,37.565352,126.978885
02694,서울역,99,19,118,37.5580158041,126.9720456834
03001,한강대교북단.LG유플러스,2882,3954,6836,37.5240499441,126.9631209528
03002,한강대교북단.LG유플러스,2300,1964,4264,37.5243060629,126.9631848403
03003,신용산역,2632,4653,7285,37.527293,126.966207
03004,신용산역,5060,2620,7680,37.527920489,126.9666192358
03005,용산우체국,1311,2098,3409,37.5314970129,126.9702350163
03006,용산우체국,1434,1547,2981,37.5320503694,126.9705640624
03007,삼각지역,1524,3543,5067,37.5351801399,126.9736858311
03008,삼각지역,3783,1471,5254,37.5359845015,126.9741608708
03009,숙대입구역,4443,4923,9366,37.543295633,126.9725377982
03010,숙대입구역,3384,2173,5557,37.5437560216,126.9722320769
03011,갈월동,2714,2520,5234,37.5509755993,126.9722373211
03012,갈월동,2886,2573,5459,37.5495337218,126.9717081909
03110,남영역,2232,1945,4177,37.542006922,126.9719271804
03111,남영역,1601,1159,2760,37.541823,126.972069
03119,신용산역3번출구,1048,1301,2349,37.5288895698,126.9673497525
03120,서울드래곤시티,45,1,46,37.5321566887,126.9630603924
03121,용산역3번출구.용산차고지,0,100,100,37.5318079061,126.9642145682
03122,한강대교북단,311,129,440,37.5249689864,126.963570714
03124,서계동,119,299,418,37.5524743044,126.9693404702
03125,서계동,61,135,196,37.5516704971,126.969221961
03126,청파동,319,315,634,37.5489916168,126.9701219815
03127,청파시장,249,235,484,37.548679027,126.9698626298
03128,숙대입구역.청파동주민센터,294,274,568,37.5453812474,126.9707772395
03129,숙대입구역.청파동주민센터,782,510,1292,37.5454861572,126.9704188578
03130,남영역,16,216,232,37.540813,126.971032
03131,남영역,136,59,195,37.5405702704,126.9706761392
03132,용산전자상가17동,137,158,295,37.5337792589,126.9660271002
03133,용산전자상가19동,96,72,168,37.5335134935,126.9657072039
03134,용산전자상가10동,282,228,510,37.5332725045,126.9619640523
03135,용산전자상가12동,103,289,392,37.5330574076,126.9621689745
03136,용산전자상가.전자랜드,159,194,353,37.5327790559,126.9583252146
03137,용산전자상가.전자랜드,279,221,500,37.5330561177,126.9583363743
03138,원효대교북단,462,584,1046,37.5319853728,126.956110982
03139,용산경찰서,850,842,1692,37.5405032098,126.9691858135
03140,용산경찰서,933,657,1590,37.5399994643,126.9690615428
03141,용산꿈나무종합타운.원효로우체국,840,823,1663,37.5386139009,126.9669290534
03142,용산e편한세상,316,754,1070,37.5374620591,126.9654677888
03143,남정초등학교,754,836,1590,37.5363187485,126.9636632444
03144,원효로2가,1051,879,1930,37.536237441,126.9629911361
03145,원효로2가사거리,283,551,834,37.5349338369,126.9610704217
03146,원효로3가,1018,794,1812,37.5340407624,126.9581798302
03147,원효로3가,813,893,1706,37.5337957151,126.9583248022
03148,용암초등학교입구.이태원주공아파트,541,755,1296,37.5441159432,126.9886645749
03149,이태원동남산대림아파트.용산동아파트,667,423,1090,37.5398743674,126.9874799728
03150,용산한신아파트,560,665,1225,37.5398054732,126.9871086322
03151,해방촌,1140,285,1425,37.537817739,126.986609087
03152,국군재정관리단,480,896,1376,37.5373177108,126.9868496115
03153,용산구청,1084,992,2076,37.530303,126.991163
03154,용산구청,929,912,1841,37.5294095764,126.9911698907
03155,한강중학교,1092,1401,2493,37.5254587536,126.9921715396
03156,한강중학교앞,1105,925,2030,37.5245025908,126.9924287738
03157,서빙고역1번출구,872,1090,1962,37.5200464191,126.9899502397
03158,장충단로입구,648,712,1360,37.545795,127.002202
03159,남산예술원,29,143,172,37.544437,127.00204
03160,서울중부기술교육원.블루스퀘어,659,725,1384,37.5415776794,127.0035397782
03161,서울시중부기술교육원.블루스퀘어,2950,2895,5845,37.5411748997,127.0031776354
03162,순천향대학병원,7433,2237,9670,37.5364422432,127.0057302453
03163,순천향대학병원,90,1140,1230,37.5356114027,127.0062993526
03164,순천향대학병원,809,57,866,37.5357934643,127.0054993584
03165,순천향대학병원.한남오거리,4542,6751,11293,37.5354906847,127.0057290409
03166,한남오거리,1732,2545,4277,37.5328478217,127.0083126426
03167,남산도서관.용산도서관,472,543,1015,37.552282,126.980835
03168,남산도서관.용산도서관,607,900,1507,37.5520442521,126.9811340112
03169,후암약수터,160,295,455,37.54869,126.98432
03170,후암약수터,220,318,538,37.548395263,126.9841668777
03171,보성여중고입구,400,762,1162,37.5463968458,126.9858399758
03172,보성여중고입구,709,608,1317,37.5462598541,126.9856317665
03173,남산체육관,149,206,355,37.5427038827,126.9927901963
03174,남산체육관,207,222,429,37.5425047481,126.992916961
03175,하얏트호텔,243,614,857,37.5417535527,126.9961358368
03176,하얏트호텔,510,330,840,37.540866103,126.9974258076
03177,용마루고개.서울자동차고등학교,457,375,832,37.5406368923,126.9584647114
03178,용마루고개.효창파크푸르지오아파트,307,268,575,37.5402999129,126.9585520334
03179,효창공원앞역.이봉창역사울림관,1806,822,2628,37.5392719714,126.9618971064
03180,효창공원앞역.이봉창역사울림관,910,1016,1926,37.5388284845,126.9626978558
03181,용산꿈나무종합타운.보건분소,832,1438,2270,37.5384268178,126.9649997667
03182,용산꿈나무종합타운.보건분소,293,345,638,37.538295,126.964648
03183,원효로제1동주민센터,1143,352,1495,37.5376607152,126.9669923459
03184,전쟁기념관,400,999,1399,37.5347586674,126.9768577525
03185,전쟁기념관,1702,570,2272,37.534651168,126.9753831458
03186,녹사평역,295,657,952,37.5351069553,126.9851183494
03187,녹사평역,550,487,1037,37.5347582183,126.9853046955
03188,용산구청.이태원시장,649,419,1068,37.5343830489,126.9904706555
03189,용산구청.이태원시장,665,799,1464,37.5341127106,126.9900096398
03190,이태원역1번출구.해밀턴호텔,514,460,974,37.534552,126.993043
03191,이태원역4번출구.해밀턴호텔,665,589,1254,37.5343539681,126.9934293088
03192,이태원119안전센터,345,552,897,37.53479,126.996387
03193,이태원119안전센터,552,552,1104,37.534604145,126.997179939
03194,한남동주민센터,507,898,1405,37.5370458894,127.0004667254
03195,한남동주민센터,747,472,1219,37.5367073033,127.0006042579
03196,한강진역.블루스퀘어,263,1398,1661,37.540805,127.001695
03197,한강진역.블루스퀘어,1555,328,1883,37.5409291837,127.0020254103
03198,서울역11번출구,817,293,1110,37.5536168846,126.9738943742
03199,후암삼거리,190,522,712,37.5525408404,126.9765772255
03200,후암시장,500,587,1087,37.5506891863,126.9770644706
03201,후암시장,1002,394,1396,37.5497467332,126.9775446282
03202,용산중고,469,271,740,37.5466597949,126.9781855672
03203,용산중고,539,488,1027,37.547205,126.978225
03204,후암동종점,690,832,1522,37.5466989277,126.9809588102
03205,용산중고,14,341,355,37.54574,126.977563
03206,남영동주민센터,204,91,295,37.5458126055,126.9768703431
03207,남영동주민센터,34,40,74,37.5453624049,126.9750573355
03208,남영우체국,869,336,1205,37.5451241168,126.973235384
03209,남영우체국,265,255,520,37.545368151,126.9734813948
03210,한남시범아파트,333,347,680,37.5379429734,127.0122607528
03211,한남시범아파트,148,451,599,37.5377041394,127.0126714787
03212,한남동,1073,901,1974,37.5339127002,127.0084445845
03213,한남동,1224,733,1957,37.5337549896,127.0087002913
03214,이촌동동부센트레빌,223,435,658,37.5215595386,126.9660096214
03215,이촌동두산위브트레지움.한강대우아파트,678,396,1074,37.5215734809,126.9675282802
03216,이촌1동충신교회앞,432,597,1029,37.5212831472,126.968480845
03217,이촌동한가람아파트.이촌역,984,663,1647,37.520656299,126.9718842721
03218,이촌동한강맨션.이촌역,738,750,1488,37.5201804898,126.972709783
03219,신용산초등학교,586,569,1155,37.5198497731,126.9745085046
03220,신용산초등학교,477,572,1049,37.5190775256,126.9762479627
03221,이촌동강촌아파트,651,296,947,37.5189178471,126.9775234206
03222,이촌동점보아파트,512,629,1141,37.5183827987,126.9784408808
03223,이촌동현대아파트,788,508,1296,37.5185336834,126.9787120007
03224,금강병원.반도아파트,282,450,732,37.517704332,126.9811234284
03225,서빙고신동아아파트,867,528,1395,37.517936953,126.9851053606
03226,서빙고신동아아파트,360,532,892,37.5174859672,126.985371435
03227,만리동고개,1374,1325,2699,37.551670014,126.9628215994
03228,손기정체육공원,596,698,1294,37.5542153265,126.9664230215
03229,숙대입구역,712,678,1390,37.544479,126.970799
03230,남영역,891,367,1258,37.5422202391,126.9709244565
03231,숙명여대도서관앞,603,707,1310,37.5448468654,126.9672216718
03232,숙명여대도서관앞,233,318,551,37.5448412411,126.9664464653
03233,숙명여대정문,181,429,610,37.5449594985,126.9641094647
03234,숙명여대정문,232,545,777,37.5451307674,126.9643096929
03235,숙명여대후문.이봉창활동터,400,852,1252,37.5460839723,126.9632996424
03236,효창공원후문,411,392,803,37.5467910299,126.9625778991
03237,한겨레신문사입구,151,333,484,37.5458806239,126.9591928852
03238,대한노인회중앙회,274,392,666,37.5437890449,126.9576684412
03239,효창운동장.효창동주민센터,327,304,631,37.5422095196,126.9617671315
03240,효창동주민센터.금양초등학교,343,295,638,37.5416239572,126.9622336676
03241,금양초등학교,310,354,664,37.5412992546,126.9620007403
03242,효창공원역,189,355,544,37.5387860159,126.9610378658
03243,도원삼성래미안아파트,167,267,434,37.539776803,126.9574338661
03244,도원삼성래미안아파트,278,136,414,37.5396254142,126.9572103137
03245,중앙하이츠빌라앞,96,228,324,37.5380144603,126.9600336494
03246,중앙하이츠빌라앞,139,127,266,37.5379738635,126.9598809227
03247,용문시장,571,404,975,37.5363479221,126.9609679808
03248,용문시장,256,321,577,37.5359792047,126.9613595571
03249,용산전자상가입구,78,215,293,37.5345701678,126.9622225151
03250,용산전자상가입구,303,119,422,37.5346611171,126.9619447091
03251,신용산지하차도,59,143,202,37.5328348806,126.963668181
03252,신용산지하차도,416,501,917,37.53259,126.963882
03253,신용산역5번출구,11,252,263,37.5300338589,126.9676784797
03255,용산역,2242,625,2867,37.5288666127,126.9658224646
03256,용산푸르지오써밋,314,150,464,37.5275756153,126.96475962
03257,용산푸르지오써밋,199,455,654,37.527230928,126.964578773
03258,용산역광장앞,975,408,1383,37.528333,126.965617
03259,용산역사박물관.용산철도고등학교,406,189,595,37.5255972846,126.9660149714
03260,용산역사박물관.용산철도고등학교,136,326,462,37.5253057707,126.9671194025
03261,용산세무서,203,118,321,37.5237318415,126.9692440232
03262,용산세무서,160,146,306,37.5236213922,126.970154424
03263,이촌역,97,293,390,37.5226689183,126.9739086458
03264,이촌역,414,164,578,37.5223634662,126.9740268751
03265,국립중앙박물관용산가족공원,195,317,512,37.5208980106,126.9786512102
03266,국립중앙박물관용산가족공원,245,277,522,37.5208754875,126.9799562027
03267,서빙고역교차로,413,278,691,37.520427,126.9899
03268,서빙고초등학교,110,66,176,37.5211711184,126.9908893645
03269,한강중학교,135,77,212,37.5251140639,126.9913627138
03270,금호베스트빌앞,27,45,72,37.5226362582,126.9907181939
03272,서빙고동,208,346,554,37.5198043185,126.9934202794
03273,서빙고동주민센터,354,219,573,37.5203840049,126.9948813029
03274,동빙고동,548,284,832,37.5208183604,126.996690677
03275,동빙고동,472,374,846,37.5212625565,126.9970390394
03276,보광신동아아파트삼성리버빌아파트,368,484,852,37.5247380028,127.0020297105
03277,보광동신동아아파트,1007,714,1721,37.5256237907,127.0015149467
03278,보광동주민센터,806,548,1354,37.5264591178,127.0005046107
03279,보광동,568,383,951,37.5280088468,126.9993070672
03280,보광동,368,530,898,37.528182014,126.998896846
03281,한국폴리텍1대학,547,659,1206,37.5301959868,126.9967926172
03282,한국폴리텍1대학,691,803,1494,37.5305293513,126.9965748167
03283,이태원역.보광동입구,1173,481,1654,37.5334,126.994213
03284,이태원역.보광동입구,512,1250,1762,37.5338224192,126.9942269972
03285,한남역.용산노인종합복지관,633,308,941,37.5312239311,127.006795706
03286,한남역.용산노인종합복지관,808,804,1612,37.5306687947,127.007769858
03287,이촌119안전센터.성촌공원,62,104,166,37.5300799765,126.9529474778
03288,성촌공원.포르쉐센터용산,42,189,231,37.5301710306,126.9546065451
03289,성촌공원.포르쉐센터용산,265,183,448,37.529747416,126.954351091
03290,이촌2동주민센터,177,396,573,37.5277364382,126.9550639882
03291,이촌2동주민센터,463,171,634,37.5277028919,126.9548605606
03292,이촌2동대림아파트.새남터성지,146,561,707,37.5261753068,126.9563230524
03293,이촌2동대림아파트.새남터성지,579,154,733,37.5260292706,126.9561658719
03294,서부이촌동입구,250,852,1102,37.5238640509,126.959495368
03295,이촌2동강변아파트,650,282,932,37.5234462055,126.9597809746
03296,원효2동산호아파트후문,9,97,106,37.5322600069,126.9500126665
03297,청암동강변삼성아파트,340,200,540,37.5346144292,126.9482434807
03298,청암동강변삼성아파트,312,613,925,37.534015,126.949323
03299,원효2동산호아파트,691,455,1146,37.5330177683,126.9505415559
03300,원효2동산호아파트,468,462,930,37.5331088986,126.9508277689
03301,원효로풍전아파트,553,378,931,37.5321286462,126.9535225314
03302,원효로풍전아파트,399,436,835,37.5323687724,126.9545135613
03303,원효풍전아파트,137,78,215,37.532742142,126.9559182022
03304,원효2동주민센터,488,478,966,37.5344941039,126.9513961673
03305,산천동리버힐삼성아파트,322,138,460,37.5345003443,126.9511923413
03306,산천동,240,71,311,37.5353203855,126.9536425118
03307,산천동,51,223,274,37.5354081306,126.9533822284
03308,신창동세방아파트,199,24,223,37.5357083247,126.954957565
03309,신창동세방아파트,26,245,271,37.5358300537,126.9549471079
03310,남이장군사당,37,78,115,37.5366590687,126.9579937738
03311,남이장군사당,29,78,107,37.5367544611,126.9575932164
03312,용문시장.용문동새마을금고,103,201,304,37.5370716239,126.9595337638
03313,용문시장.용문동새마을금고,320,112,432,37.5371492138,126.9591968331
03319,순천향병원입구,456,496,952,37.5326305473,127.0067505734
03320,남산서울타워,2255,2190,4445,37.5510144684,126.9911947846
03321,청심경로당,104,40,144,37.5338879189,126.9506907463
03322,삼성테마트,44,57,101,37.5337466904,126.9503849242
03323,서빙고동금호베스트빌,41,40,81,37.5226137862,126.9909910111
03324,한남동하이페리온,128,250,378,37.5278439771,127.0055474264
03325,서빙고역1번출구,294,311,605,37.5200345091,126.9894855098
03326,문배동이안아파트앞,29,120,149,37.5388699959,126.971060418
03327,갈월동.숙대입구역10번출구,405,412,817,37.5463858567,126.9716591639
03328,삼각지역11번출구,127,801,928,37.536204,126.974548
03330,숙대입구,228,62,290,37.5445305498,126.9705229419
03331,원효대교북단,538,209,747,37.5321383559,126.9556102561
03332,문배동이안아파트앞,161,307,468,37.5383644982,126.9707994501
03334,순천향병원입구,385,443,828,37.532694511,127.0069961164
03335,숙명여대입구,330,114,444,37.5448844577,126.9696434774
03336,서빙고초등학교,36,93,129,37.5208412941,126.9906099662
03338,한강대교스카이스위트,19,84,103,37.5213307725,126.9608161519
03339,한강대교전망카페,9,43,52,37.5212359951,126.9613434997
03340,노들섬,616,717,1333,37.5175161768,126.9586051825
03341,노들섬,710,864,1574,37.5173638437,126.959037665
03342,용암초등학교.이태원2동주민센터,74,101,175,37.544673,126.990733
03343,용암초등학교.이태원2동주민센터,47,228,275,37.5448496669,126.9909320571
03344,효창공원삼거리.윤봉길의사등묘역,79,424,503,37.5446070869,126.9638368968
03345,서울역공항철도15번출구,471,233,704,37.5530779085,126.9688467509
03346,용산꿈나무종합타운,1501,910,2411,37.538486933,126.9672402984
03347,남산도서관.용산도서관,405,567,972,37.552343667,126.9818461928
03500,하얏트호텔,327,526,853,37.5406603781,126.9969932623
03501,한신아파트,1039,227,1266,37.5389827262,126.9866957386
03502,순천향병원,148,144,292,37.5332487951,127.0048157354
03503,용암경로당입구,257,49,306,37.540596615,126.9869183825
03504,한남오거리,40,10,50,37.5330901125,127.0066566991
03505,가야랑앞,128,7,135,37.5401952774,126.9936040739
03506,용암한신아파트,201,76,277,37.5420771725,126.987435288
03508,효창공원후문,183,406,589,37.5470688427,126.9608920893
03509,디지텍고등학교앞,318,9,327,37.5398031767,126.9916260429
03510,우리들가정의원,346,102,448,37.5432315144,126.9877949646
03511,도원삼성래미안아파트101동앞,6,60,66,37.5390685906,126.9562320809
03512,성도약국,155,21,176,37.5394506828,126.9895541036
03513,남산교회입구,236,245,481,37.5446713415,126.9866471968
03515,신애교회,47,149,196,37.5455190385,126.9584869002
03516,시장,203,31,234,37.5389225472,126.9885515774
03517,해방촌오거리,1005,761,1766,37.54572995,126.9851474983
03518,보광동주민센터,80,41,121,37.5261473387,127.0000973012
03519,대한노인회중앙회,112,210,322,37.5440368054,126.9576286965
03520,도원삼성래미안아파트101동앞,57,18,75,37.5390222559,126.9562965631
03521,신흥교회앞,447,86,533,37.5447457188,126.9833867831
03522,군인아파트,66,107,173,37.526004062,126.9963176555
03523,원효사.백범김구기념관,81,75,156,37.5431401733,126.9585663043
03524,녹사평역,49,252,301,37.5350110363,126.9858713342
03525,큰빛의집앞,119,94,213,37.5445481753,126.9819982464
03526,몬드리안서울이태원,29,20,49,37.528596,126.992589
03527,도원삼성래미안아파트,46,6,52,37.5396879497,126.9576859474
03529,후암동종점,795,282,1077,37.5467007949,126.9813662289
03530,용산구청,42,37,79,37.530573,126.991477
03532,용산고등학교,365,268,633,37.5461364014,126.9795092308
03533,외빈차고,33,12,45,37.531832,126.992242
03534,효창공원앞역.이봉창역사울림관,160,215,375,37.5396710223,126.9614323385
03536,갈월동사회복지회관,179,604,783,37.5453901296,126.9740851958
03537,청화아파트,12,37,49,37.531157,126.995387
03540,용산경찰서,75,55,130,37.5410233025,126.969805735
03541,숙대역7번출구,494,1305,1799,37.5434757805,126.9722967638
03542,보광동삼거리,28,43,71,37.530752,126.996811
03543,중앙하이츠빌라,41,46,87,37.5385683269,126.9594786383
03544,원효우체국,55,33,88,37.538967266,126.967353845
03545,보광초등학교,11,28,39,37.531373,126.99673
03546,용문동시장.새마을금고,278,86,364,37.5373482951,126.9596343248
03550,용문동주민센터,77,12,89,37.5381473907,126.9591190202
03551,문배어린이공원,137,26,163,37.5369383946,126.9697251251
03552,문배어린이공원,373,450,823,37.5371431249,126.9695900372
03561,신용산역,418,323,741,37.5299166547,126.9674544999
03564,용산우체국,242,115,357,37.531376286,126.9703153999
03565,숙대역5번출구,1128,276,1404,37.54403813,126.9725114972
03567,삼각지역,172,61,233,37.5345065492,126.9732731006
03568,갈월동,54,77,131,37.5463241118,126.9720930552
03569,보광초등학교후문앞,6,16,22,37.533162,126.995635
03571,동자경로당,101,253,354,37.5502867059,126.9741955461
03572,이태원역앞,48,41,89,37.534339,126.9957
03573,녹사평역.용산구청,601,918,1519,37.5351395786,126.9871837649
03574,후암시장,220,487,707,37.5500664789,126.9768043541
03577,후암동주민센터앞,183,209,392,37.5483644838,126.9777057507
03578,제일기획,4,23,27,37.53495,126.998418
03579,대성교회,74,132,206,37.5386999666,126.9884520307
03580,용산고,182,296,478,37.5459083263,126.9789524928
03581,성도약국,57,135,192,37.5392776612,126.9894307824
03582,후암동종점,404,317,721,37.5465016517,126.9813594882
03583,디지텍고등학교앞,61,428,489,37.5397139842,126.9918569023
03584,큰빛의집앞,106,145,251,37.5444832826,126.9819077271
03585,가야랑앞,19,146,165,37.5400889559,126.9937523252
03586,신흥교회앞,137,417,554,37.5446231699,126.983387942
03588,해방촌오거리,525,1287,1812,37.5457029481,126.9853964787
03589,남산교회입구,138,161,299,37.5445505919,126.9866223212
03590,우리들가정의원,192,219,411,37.5432423134,126.9876591627
03591,용암한신아파트,65,122,187,37.5423880484,126.9874137344
03592,용암경로당입구,189,226,415,37.5410985304,126.9869601654
03593,한신아파트,29,492,521,37.5389881171,126.986557682
03594,갑을빌딩,280,111,391,37.5490958683,126.9720388292
03595,리버힐삼성아파트후문,198,6,204,37.5349462412,126.9487207623
03596,만리시장입구,357,278,635,37.5515678017,126.9630412782
03597,배문중고등학교,214,334,548,37.5503749309,126.9636168092
03598,청파초등학교,194,345,539,37.5485834792,126.9633754859
03688,청파초등학교,189,684,873,37.5484699816,126.9635056923
03699,배문중고교,109,318,427,37.550381273,126.963728852
03700,만리시장입구,48,312,360,37.5517759871,126.9631453007
03709,청암자이아파트,3,320,323,37.5348672272,126.9485683053
03737,도원삼성래미안아파트단지내,306,617,923,37.5381983039,126.9553881353
03742,한남동주민센터,3,28,31,37.534102,127.000603
03743,용산CJ나인파크.오리온앞,15,21,36,37.5358706647,126.9695530125
03744,용산e편한세상,105,72,177,37.5344621995,126.9672212005
03753,필리핀대사관,64,2,66,37.5406999627,126.995093255
03754,필리핀대사관,0,80,80,37.5405702075,126.9951600296
04001,답십리역사거리,1279,1729,3008,37.5654496127,127.0543961703
04002,청년회의소.서울새활용플라자,1460,1941,3401,37.5620353607,127.0604823356
04003,장한평역,2199,2271,4470,37.5611899215,127.0660926512
04101,상왕십리역,911,564,1475,37.5643358035,127.0290748599
04102,상왕십리역,1750,3282,5032,37.5646936321,127.0286812869
04103,왕십리센트라스아파트,729,1241,1970,37.5652129966,127.0248051787
04104,왕십리교회,405,528,933,37.566630044,127.0236794054
04105,뉴타운아파트,229,475,704,37.5648723959,127.0269697789
04106,청계벽산아파트.텐즈힐아파트,644,756,1400,37.5688584755,127.0303755149
04107,텐즈힐아파트.청계벽산아파트,739,528,1267,37.5679598186,127.0300384029
04108,왕십리도선동주민센터,271,117,388,37.5676164369,127.0246446774
04109,왕십리2동주민센터,1215,942,2157,37.56244961,127.0332625935
04110,코스모타워.서울신용보증재단성동지점,1006,1298,2304,37.5629822568,127.032902865
04112,성동구청,948,1469,2417,37.5631265853,127.0359164214
04113,상왕십리역,1832,561,2393,37.5648716583,127.0302446401
04114,상왕십리역.센트라스아파트,547,1192,1739,37.5658601065,127.0299768448
04115,신금호역4번출구,303,101,404,37.5541428107,127.0205310813
04116,마장동주민센터,178,373,551,37.5673234964,127.04457376
04117,마장역,667,315,982,37.5655987334,127.0422829487
04118,성동노인복지관,263,279,542,37.5649375925,127.0415861333
04119,마장축산물시장,1276,1069,2345,37.5709505267,127.0380207293
04120,마장축산물시장,1610,1693,3303,37.5702590064,127.0375113528
04121,도선사거리,512,516,1028,37.5670208209,127.0369539875
04122,도선사거리,535,1089,1624,37.5666487791,127.0364845717
04123,마장동금호아파트,100,141,241,37.5630713327,127.041859032
04124,마장동금호아파트,137,688,825,37.5621577226,127.0415811922
04125,한양대부속고등학교,909,151,1060,37.5609241011,127.0414131621
04126,한양대부속고등학교,291,422,713,37.5603881249,127.0411546041
04127,한양대앞.한양시장,403,331,734,37.5585823987,127.0409668475
04128,한양대앞,237,189,426,37.5585254607,127.0406535419
04129,한양대정문,1553,832,2385,37.5563883665,127.0431286432
04130,한양대정문앞,1168,1748,2916,37.5569939038,127.0431384444
04131,무학여고앞,1291,1254,2545,37.5578540014,127.0342332122
04132,무학여고,2267,2029,4296,37.5578953118,127.0338672615
04133,왕십리역,948,703,1651,37.5599473134,127.0361920228
04134,왕십리역,295,966,1261,37.5603365628,127.0362669183
04135,왕십리역,320,331,651,37.5607235444,127.0346872504
04136,행당1동주민센터.성동소방서,490,325,815,37.5582671772,127.0384039964
04137,서울숲삼부아파트,354,621,975,37.5587230766,127.0379492742
04138,응봉동주민센터,317,336,653,37.5533989566,127.0335007802
04139,응봉동주민센터,354,770,1124,37.5537612141,127.0334386918
04140,응봉사거리,1833,1768,3601,37.5552918803,127.0344580408
04141,응봉동현대아파트,977,435,1412,37.5497324573,127.0305745164
04142,응봉동현대아파트,474,745,1219,37.550222,127.0309
04143,대현산배수지공원입구,240,162,402,37.5564740008,127.0200356974
04145,신금호역,206,378,584,37.5556051708,127.020117586
04146,신금호역,449,376,825,37.5556768698,127.0199214015
04147,금호고등학교,127,213,340,37.5534780746,127.0219550538
04148,금호고등학교.금호자이1차아파트입구,64,76,140,37.5531077251,127.0229328751
04149,금호동벽산아파트,480,383,863,37.5511643996,127.0256791281
04150,래미안하이리버아파트,321,330,651,37.5514582119,127.0254234439
04151,금호사거리,516,230,746,37.5488791385,127.02606314
04152,금호사거리,95,298,393,37.5494639682,127.0259773298
04153,금남시장앞.백범학원터,1661,791,2452,37.5480852238,127.0218686315
04154,금남시장앞.백범학원터,1250,1323,2573,37.5482887551,127.022487755
04155,금호역,487,1062,1549,37.5477283731,127.0162669926
04156,금호역,589,178,767,37.5485477051,127.0154795051
04157,금옥초등학교앞,557,605,1162,37.5469673139,127.0198923146
04158,금옥초등학교앞,436,636,1072,37.5462572048,127.0182356475
04159,힐스테이트서울숲리버아파트,620,459,1079,37.5478877101,127.0270575925
04160,삼성래미안아파트앞,377,674,1051,37.5483498668,127.0275127211
04161,옥수삼성아파트.래미안옥수리버젠,814,443,1257,37.5436204852,127.0148475565
04162,옥수삼성아파트.래미안옥수리버젠,644,594,1238,37.5438034317,127.0146552078
04163,미타사입구,90,154,244,37.5448556208,127.0168373163
04164,래미안옥수리버젠.옥수중앙교회,44,340,384,37.5459155767,127.0148446166
04165,래미안옥수리버젠.옥수중앙교회,203,86,289,37.545782,127.014698
04166,옥수파크힐스아파트앞,73,277,350,37.5471160945,127.0130389488
04167,옥수파크힐스아파트앞,203,126,329,37.5470204344,127.0130159995
04168,옥수동종점,268,278,546,37.5493374753,127.0125833169
04169,옥정중학교입구,536,658,1194,37.5409040726,127.011302745
04170,옥정중학교입구,786,406,1192,37.5408770683,127.0109994635
04171,성수1가1동새마을금고,107,488,595,37.5382204647,127.0495477418
04172,성수1가새마을금고,508,79,587,37.5383306996,127.0495105089
04173,천주교성수동성당앞,457,81,538,37.5393704675,127.0461393549
04174,천주교성수동성당앞,106,504,610,37.539305526,127.0460740289
04175,뚝도아리수정수센터수도박물관,221,356,577,37.5409772406,127.044202626
04176,뚝도아리수정수센터수도박물관,40,268,308,37.541407,127.04399
04177,서울숲역2번출구,1065,687,1752,37.5429317268,127.0447086131
04178,서울숲역3번출구,842,743,1585,37.5430629438,127.0444980594
04179,성동구민종합체육센터,893,424,1317,37.5460719745,127.0448960891
04180,성동구민종합체육센터,461,943,1404,37.5464979897,127.0445340491
04181,성수공고앞,358,101,459,37.5399724321,127.0503149591
04182,성수공고앞,96,288,384,37.5400388326,127.050759594
04183,경일초등학교입구,112,8,120,37.5410800235,127.0463723692
04184,경일초등학교입구,8,99,107,37.5413797453,127.0460161257
04185,성동교남단,710,431,1141,37.5495163646,127.0444566298
04186,성동교남단,254,538,792,37.5505075164,127.0439627696
04187,상원,353,368,721,37.5514371326,127.0460506002
04188,상원,228,471,699,37.551747737,127.0466618972
04189,영동대교북단,2040,858,2898,37.5369424226,127.0607392694
04190,경수중학교,726,599,1325,37.5397602612,127.0624288917
04191,성수119안전센터,266,245,511,37.5373416869,127.060132085
04192,성수119안전센터,196,349,545,37.537532,127.059997
04193,경수중학교,213,95,308,37.5381650347,127.0570118184
04194,경수중학교,87,348,435,37.5382865442,127.0572982039
04195,뚝도시장,524,145,669,37.5385866142,127.0553996133
04196,뚝도시장,139,486,625,37.5388507297,127.0552587843
04197,성원중성수동이마트앞,283,105,388,37.5390939396,127.0534264696
04198,성원중성수동이마트앞,87,171,258,37.539511,127.052845
04199,서울숲지구대앞,77,525,602,37.537867716,127.0523417008
04200,서울숲지구대앞,679,112,791,37.5380509168,127.0522588868
04201,뚝도시장구길,90,498,588,37.537192,127.05527
04202,뚝도시장구길,531,141,672,37.5375520694,127.0549267531
04203,성수동진주타운,88,103,191,37.536617437,127.0574889191
04204,성수동진주타운,119,104,223,37.536759089,127.0574923078
04205,영동대교,14,106,120,37.536356,127.059982
04206,영동대교,215,74,289,37.5364382069,127.06006565
04207,화양사거리,1408,987,2395,37.5472776746,127.0666629344
04208,성수사거리.성수초등학교,333,402,735,37.5428218897,127.0641612973
04209,서울효사랑병원,417,566,983,37.5412636389,127.0632745484
04210,성수2가3동주민센터,446,369,815,37.5496243675,127.0553883888
04211,제인병원,224,260,484,37.5493511273,127.0568366874
04212,성동세무서앞,475,657,1132,37.5479946812,127.0621853946
04213,성동세무서,1333,622,1955,37.548239128,127.064337342
04214,송정동서울숲아이파크,421,377,798,37.551825481,127.0692473283
04215,송정동건영아파트,446,318,764,37.555205,127.07115
04216,군자교남단,314,339,653,37.5575371596,127.0724414557
04217,신답역,818,443,1261,37.570211077,127.0475025717
04218,용답동.로데오거리.답십리역,839,383,1222,37.5657033305,127.0539458148
04221,서울교통공사.서울새활용플라자,101,151,252,37.5620495039,127.0569134234
04222,뚝섬서울숲,393,444,837,37.544618041,127.036601198
04223,뚝섬서울숲,520,703,1223,37.5456718598,127.0363946274
04226,사근동하이츠아파트앞,41,246,287,37.5611984155,127.0486060331
04227,사근동하이츠아파트앞,434,10,444,37.561306176,127.0486881757
04228,사근동주민센터,4,168,172,37.5608144197,127.0456489178
04229,사근동주민센터,136,6,142,37.5609315252,127.0457112392
04230,사근고개,7,168,175,37.5611617078,127.0445908781
04231,사근고개,110,49,159,37.5612555615,127.0445101518
04232,한양지구대,196,128,324,37.5602143513,127.0420211147
04233,한양지구대,82,112,194,37.5602445802,127.0419242341
04234,사근동벽산아파트,16,87,103,37.5601892041,127.0499269056
04236,뚝섬역8번출구,514,578,1092,37.5476928251,127.0455095172
04237,뚝섬역2번출구,549,179,728,37.547575,127.046846
04238,뚝섬역5번출구,628,372,1000,37.5464803389,127.0492754339
04239,뚝섬역4번출구,501,500,1001,37.5468001934,127.0492756444
04240,성수역1번출구,850,1041,1891,37.5454196769,127.0538293527
04241,SK테크노빌딩앞,22,58,80,37.545888,127.050228
04242,SK테크노빌딩앞,138,45,183,37.545769848,127.0500259308
04243,경동초등학교입구,77,152,229,37.5437724292,127.0494809367
04244,경동초등학교입구,209,103,312,37.5433912967,127.049212934
04245,경일초등학교앞,103,175,278,37.5407684319,127.0482363415
04246,경일초등학교앞,149,128,277,37.540919377,127.0481685479
04247,한양여대앞,25,120,145,37.55951,127.0503
04252,도선고등학교.꽃재교회,127,45,172,37.5670932118,127.0277827978
04253,성수역4번출구,677,420,1097,37.5447878607,127.0545807481
04254,리버하우스,349,301,650,37.5509002648,127.0510060889
04255,리버하우스,283,281,564,37.5512302013,127.0506905447
04256,성수사거리,191,367,558,37.542562,127.062352
04257,성수사거리,330,253,583,37.5427980761,127.0623621248
04258,성동제일새마을금고,18,327,345,37.560811596,127.0471032979
04259,성동제일새마을금고,337,6,343,37.560884127,127.0473012813
04261,청계9가.텐즈힐2단지정문앞,93,46,139,37.570749453,127.0255654313
04264,뚝섬서울숲,228,26,254,37.5434527836,127.0375618762
04265,서울숲1번출구,22,59,81,37.5422230617,127.0426958799
04266,서울숲1번출구,36,18,54,37.5419781098,127.042974358
04267,용답휴식공원,72,282,354,37.5693121111,127.0480538231
04268,용답휴식공원,189,314,503,37.5695541839,127.0479373245
04269,성수2가3동주민센터,159,216,375,37.5504251323,127.0542376417
04270,극동그린아파트앞,109,149,258,37.5420008413,127.0113916813
04271,마장역,195,418,613,37.5663469729,127.0430338383
04272,행당신동아.행당푸르지오아파트,728,433,1161,37.5561408382,127.0340192689
04273,숭신초등학교,71,67,138,37.5671676226,127.028195858
04275,극동아파트,405,201,606,37.5580974527,127.0239338279
04276,풍림아파트,436,427,863,37.5591427175,127.0239062231
04277,벽산아파트,237,234,471,37.555602288,127.0256885739
04278,대림아파트,196,261,457,37.5565738309,127.0249260274
04279,행당역,862,577,1439,37.557000896,127.0290982639
04280,행당역,497,408,905,37.557079373,127.0287643907
04281,무학여고,242,217,459,37.5583911544,127.0330162995
04282,극동그린아파트,149,34,183,37.5420646255,127.011904958
04286,성수동차고지,162,6,168,37.535793,127.055682
04288,제민약국,99,82,181,37.5365921538,127.0585185177
04289,왕십리자이.신당현대아파트,115,107,222,37.560847,127.02363
04290,왕십리자이.신당현대아파트,425,335,760,37.5611519007,127.024102104
04291,제민약국,9,80,89,37.536507,127.058488
04293,우리은행화양동지점,825,797,1622,37.548116421,127.0661376875
04295,황학교.텐즈힐몰,301,350,651,37.5700517505,127.0236037286
04298,마장동주민센터,190,155,345,37.5670632137,127.0446425019
04301,왕십리광장.왕십리역7번출구,850,1462,2312,37.5611283256,127.0368888269
04302,왕십리광장.왕십리역4번출구,2142,1093,3235,37.561364441,127.037133352
04303,한양대동문앞,11,91,102,37.5556432919,127.0496759962
04304,왕십리도선동주민센터,106,76,182,37.5678169566,127.0244126998
04305,한양여대앞,189,2,191,37.5592243864,127.050619338
04306,행당중학교,15,54,69,37.553821,127.044352
04307,살곶이체육공원앞,25,3,28,37.5563590432,127.05101917
04500,송정동현대아이파크아파트,227,206,433,37.5521871167,127.0686200823
04501,극동아파트5동,227,394,621,37.5431595377,127.0110790155
04502,대우아파트관리실,206,152,358,37.5462141244,127.0199839497
04504,신금호역,470,306,776,37.5545931778,127.0204908209
04505,옥수역,2146,860,3006,37.5414827461,127.016816639
04506,송정동자치회관,95,9,104,37.5508854915,127.0687627665
04507,대우아파트후문,88,40,128,37.5469390691,127.0216589278
04509,금호1가동주민센터,11,24,35,37.5551290207,127.02219553
04510,왕십리민자역사,2869,2032,4901,37.5618426928,127.0378535089
04511,무쇠막,75,317,392,37.545277754,127.0246947943
04512,송정어린이집,56,6,62,37.5490025833,127.0677474298
04514,대경생활과학고등학교,75,0,75,37.5559714265,127.017537043
04515,금북초등학교.e편한세상금호105동,62,48,110,37.5555378179,127.0237361041
04516,무학여고,277,253,530,37.5574916088,127.0339123541
04517,힐스테이트서울숲리버,92,171,263,37.5467445912,127.0253856278
04518,성수SKV1센터1동,301,24,325,37.545816932,127.0655811779
04519,극동아파트상가,79,6,85,37.5429197459,127.0121008716
04520,금호4가동주민센터.국민은행금호동지점,299,168,467,37.5480526537,127.0225635106
04521,화단삼거리,83,213,296,37.5484174167,127.0198766785
04522,금호어린이집,5,0,5,37.5567335018,127.0186201668
04523,논골.금호벽산아파트.성동공유센터,701,138,839,37.5555394907,127.0253044367
04524,행당서울숲푸르지오상가앞,104,57,161,37.5556173736,127.0338926682
04525,법학학술정보관,39,120,159,37.5570403271,127.0485750382
04526,성수이비즈센터,121,15,136,37.5465773977,127.0630583777
04527,한남하이츠아파트,53,8,61,37.5400543105,127.0115923113
04528,금호사거리,63,129,192,37.5480015945,127.0252690969
04529,금호산입구,23,3,26,37.5567220851,127.0195736658
04530,한진아파트후문,49,95,144,37.5560183016,127.0269971479
04531,신동아아파트후문,6,61,67,37.554894681,127.032693675
04532,올림픽체육관맞은편,26,45,71,37.5569341632,127.0492908049
04533,경수중학교입구,20,180,200,37.5435110445,127.0600882973
04535,제일감리교회,172,155,327,37.547866119,127.0269036684
04536,신금호역,614,51,665,37.5543806178,127.019636929
04537,제3법학관,83,29,112,37.556233909,127.0486367607
04538,행당서울숲푸르지오109동앞,21,101,122,37.5544534388,127.0317164122
04539,벽산아파트정문,60,44,104,37.5526575016,127.0252791565
04540,성수역2번출구,20,838,858,37.5442691048,127.0576390687
04541,옥수종합사회복지관,56,80,136,37.5408804856,127.0128519457
04542,응봉동현대아파트,263,221,484,37.5498025299,127.0307682168
04544,행당2동주민센터,94,159,253,37.5577375973,127.0306537631
04545,삼거리정자앞,14,89,103,37.5526279318,127.031642249
04546,금호119안전센터,6,83,89,37.5541870617,127.0247307916
04547,경동초등학교입구,189,65,254,37.5458938897,127.0511563146
04548,옥수삼성아파트,42,35,77,37.540635263,127.0139484516
04549,현대공업사앞,63,49,112,37.549950728,127.0325677907
04550,두산상가후문,8,2,10,37.5491853986,127.0167386956
04551,중앙병원,109,61,170,37.5519612784,127.0193175559
04552,무학중학교.무학여고,139,280,419,37.5582100032,127.0331282771
04553,만물상회앞,55,173,228,37.552827269,127.0312234362
04554,논골사거리,294,364,658,37.5553150263,127.0248124231
04556,응봉초등학교.대림아파트,175,114,289,37.5510678445,127.0334306978
04557,한신아파트,133,83,216,37.5507538149,127.0192957404
04558,올림픽체육관앞,32,0,32,37.5570151108,127.0496303854
04559,상봉노인정앞,46,183,229,37.5528739435,127.030283193
04560,논골신협.대림아파트후문,297,500,797,37.5577029753,127.0245743869
04562,옥수삼성아파트,77,108,185,37.5407532621,127.0143207799
04563,응봉역.광희중,218,109,327,37.5520425408,127.0344339086
04564,우리은행.백범학원터,9,46,55,37.5480069051,127.0211726304
04566,금호공원,18,87,105,37.5496769604,127.0195750088
04567,대현산체육관입구,78,166,244,37.5530799025,127.0298541873
04568,한양대학교경영대학,158,4,162,37.5570853955,127.0485297971
04569,성수역4번출구,923,8,931,37.5447702802,127.0546617999
04570,옥수종합사회복지관,64,121,185,37.5408867518,127.0132276487
04572,대우아파트입구,45,142,187,37.5459834381,127.0191632324
04573,원형화단,183,302,485,37.548592957,127.0194898441
04574,성동구청,2426,1436,3862,37.5641355512,127.0364064374
04575,금봉어린이집.또또와마트,66,23,89,37.5529061904,127.0288090654
04576,한양대병원후문,39,76,115,37.5600051066,127.0419651568
04577,경수중학교입구,88,18,106,37.5433629833,127.0596206188
04578,옥정중학교,146,767,913,37.5413329917,127.0113322323
04579,응봉사거리,510,207,717,37.5548674402,127.0345427336
04582,천은교회.성동청소년상담복지센터,0,17,17,37.554695676,127.0267906941
04583,극동아파트상가,27,105,132,37.5429116083,127.0123679427
04584,무학여고,202,210,412,37.5577185854,127.0342554186
04585,한전입구,49,146,195,37.5662652006,127.0351185322
04586,논골입구.성동공유센터,8,59,67,37.5555496417,127.0255715552
04587,극동아파트7동,25,147,172,37.5436189277,127.0127539602
04588,성동보건소,30,71,101,37.566494637,127.0331862828
04589,행당역.대림아파트정문,982,468,1450,37.5570496595,127.0286715654
04590,청계벽산아파트,118,337,455,37.568262437,127.0303705362
04591,논골.e편한세상금호114동,39,307,346,37.55519162,127.0246041221
04593,코스모타워.서울신용보증재단성동지점,93,137,230,37.5627939863,127.0332903821
04594,화단앞,567,123,690,37.5486244682,127.019653956
04595,성동사회복지관.청계천박물관,521,463,984,37.5703034715,127.0334777845
04596,금호119안전센터,82,47,129,37.5542636796,127.0245723767
04597,왕약국,51,132,183,37.5483411874,127.0655472648
04598,상왕십리역,443,231,674,37.5647437014,127.0302513803
04599,금호공원,10,82,92,37.5496507955,127.0197741925
04600,성동구도시관리공단.서울시설공단,234,273,507,37.5718289131,127.0368611826
04602,e편한세상금호117동,21,91,112,37.5526576279,127.0246821893
04603,왕십리자이.신당현대아파트,183,482,665,37.5608470716,127.0236902472
04615,중앙슈퍼,29,75,104,37.5495156648,127.0665317949
04648,한신아파트,130,274,404,37.550758302,127.0194077879
04651,금호고등학교,48,29,77,37.5530983943,127.0235529542
04658,극동.풍림아파트,73,342,415,37.5590448945,127.0236410045
04659,GS25,53,74,127,37.5503046673,127.0671617628
04667,중앙병원앞,2,206,208,37.5521279557,127.019471524
04668,도선동사거리,176,83,259,37.5667675811,127.0365326655
04669,논골신협.대림아파트후문,165,329,494,37.5575119549,127.0245188619
04670,송정동자치회관입구,59,102,161,37.5511350971,127.0678257351
04671,성동구청,132,177,309,37.563354049,127.0360410344
04672,논골사거리,121,170,291,37.5561260191,127.0247742087
04674,신금호역,219,674,893,37.5543355851,127.0197856168
04677,성동중앙교회.벽산아파트정문,33,56,89,37.5530067236,127.0248775221
04679,무학중학교.무학여고,485,186,671,37.5584226161,127.0332891007
04680,천은교회.성동청소년상담복지센터,1,8,9,37.5545919447,127.0266661363
04684,금호어린이집,0,48,48,37.5567429983,127.0182314515
04685,행당2동주민센터,58,158,216,37.5578295691,127.0304206318
04686,금봉어린이집.또또와마트,73,101,174,37.5526423775,127.028794376
04691,대경생활과학고등학교,0,287,287,37.5560687475,127.0175178242
04696,대현산체육관입구,100,109,209,37.5529629395,127.0297135329
04697,GS주유소,230,94,324,37.546811328,127.0251253545
04698,대림아파트후문,75,284,359,37.5561715023,127.026932687
04699,응봉하이퍼마트,68,50,118,37.5526731081,127.0302182436
04700,서울숲푸르지오아파트정문,180,47,227,37.5452561903,127.0243937555
04701,대림상가,68,351,419,37.553878282,127.0344662233
04702,충북상회,88,29,117,37.5527922994,127.0310093901
04706,서울숲푸르지오아파트후문,402,121,523,37.5435444033,127.0228036345
04739,응봉역.광희중,250,137,387,37.5522011423,127.0344034229
04740,삼거리정자,25,4,29,37.5523884273,127.0316939654
04741,금호초등학교,6,288,294,37.5526884328,127.0194943061
04742,응봉초등학교.대림아파트,107,116,223,37.5508020956,127.0331680056
04743,행당서울숲푸르지오109동앞,27,8,35,37.5543861249,127.031801204
04744,현대공업사앞,53,53,106,37.5501059259,127.0324416568
04745,신동아아파트후문,6,29,35,37.5546877083,127.0328358347
04746,신동아아파트,185,126,311,37.5497675599,127.0300981967
04748,행당서울숲푸르지오상가앞,12,64,76,37.5555729913,127.0340186862
04749,삼성래미안아파트,164,170,334,37.5483750866,127.0275591319
04750,금호사거리,122,156,278,37.5481765011,127.0250613034
04751,금남시장앞.백범학원터,192,204,396,37.5482744945,127.0216479967
04753,왕십리광장.왕십리역7번출구,442,1147,1589,37.5610465475,127.0365162885
04754,두산상가후문,4,6,10,37.5493384196,127.0166850915
04755,극동아파트7동,28,7,35,37.543720761,127.0126657069
04756,두산아파트111동,35,10,45,37.5505884957,127.016075787
04757,두산아파트109동,18,0,18,37.54988947,127.0166306849
04758,극동아파트4동,2,133,135,37.5435316415,127.011588323
04759,극동아파트4동,77,3,80,37.5435055002,127.0116845111
04760,두산아파트109동,0,38,38,37.5499149882,127.0167969818
04761,두산아파트115동,180,151,331,37.5510558771,127.0159606783
04762,금호역,713,1649,2362,37.5485492158,127.0169908982
04763,두산아파트정문.금호역,311,175,486,37.5486130124,127.0166207533
04764,금호역,619,11,630,37.5484240169,127.0164272951
04765,금호역.3호선,785,55,840,37.5482942315,127.0166253219
04766,화단삼거리,129,53,182,37.5482189796,127.0196278194
04767,두산아파트111동,10,264,274,37.5507879397,127.0162396281
04770,벽산아파트501동앞,25,108,133,37.5548866966,127.0254385471
04771,벽산아파트505동앞,25,67,92,37.5544010055,127.0262518161
04772,벽산아파트111동앞,58,101,159,37.5530630754,127.0267897943
04773,벽산아파트206동앞,77,113,190,37.5521525445,127.027267386
04774,벽산아파트202동앞,149,21,170,37.5514902482,127.027346896
04775,벽산하이피아상가앞,19,14,33,37.5521961609,127.0256432644
04776,우리은행.백범학원터,30,83,113,37.5482659508,127.0211246097
04780,행당푸르지오아파트,43,152,195,37.556239062,127.0340034675
04800,래미안옥수리버젠아파트상가,9,50,59,37.5443727865,127.0157270249
04801,옥수동주민센터.옥수동성당,45,39,84,37.5436061689,127.0140191688
04802,국민은행,64,49,113,37.5426971627,127.0122219232
04803,국민은행,26,74,100,37.5427782048,127.0127560803
04804,옥수동주민센터.옥수동성당,33,60,93,37.5432376614,127.0136716778
04805,삼성아파트정문,86,79,165,37.5438267793,127.015293478
04807,성동노인종합복지관,54,2,56,37.5652097737,127.0414402566
04808,중앙하이츠아파트,54,1,55,37.5652526914,127.0389001215
04809,민자역사후문,32,21,53,37.5635492836,127.0383642631
04811,금호1가동주민센터,82,249,331,37.5547282857,127.0208123009
04812,금호정형외과,338,64,402,37.5540867685,127.0204578591
04814,금호고등학교,28,6,34,37.5529799549,127.0233929107
04815,벽산하이피아상가,30,23,53,37.5519671275,127.026001811
04816,벽산노인정,16,36,52,37.551058711,127.0268504902
04817,벽산아파트107동,44,116,160,37.5516875417,127.0274313269
04818,벽산아파트109동,32,48,80,37.5526114413,127.0274448395
04819,벽산아파트505동,8,26,34,37.5543216827,127.0263706309
04820,벽산아파트501동,3,10,13,37.5550078999,127.0255887508
04821,광희중학교.응봉역,33,82,115,37.5519110306,127.035058499
04822,한신아파트후문,126,19,145,37.5537403049,127.0370729773
04823,한신아파트정문,24,12,36,37.5548347521,127.035382546
04824,민자역사후문,1,10,11,37.56308291,127.0386950898
04825,중앙하이츠아파트,6,43,49,37.5650542998,127.0384486598
04826,삼성래미안아파트,5,57,62,37.565494021,127.0402755817
04827,금북초등학교입구,31,28,59,37.5556558853,127.0236161649
04828,대현산배수지공원앞,1,64,65,37.5551777057,127.0220574589
04829,선영약국,4,44,48,37.5667721811,127.0306171809
04830,텐즈힐아파트101동.115동,18,49,67,37.5669824288,127.029279632
04831,숭신초등학교.도선고등학교앞,14,66,80,37.5673296859,127.0271676387
04832,왕십리도선동주민센터,119,139,258,37.5677084261,127.0259157424
04833,텐즈힐아파트120동.213동앞,100,88,188,37.56912306,127.0260063322
04834,왕십리중앙교회,84,62,146,37.5700015585,127.026707232
04835,옥수역,331,17,348,,
04836,청계현대아파트,231,265,496,37.5701654913,127.0430256561
04837,청계장원아파트,32,1,33,37.5693291776,127.044748559
04839,마장2교사거리,18,12,30,37.5679751585,127.0454636903
04840,마장2교사거리,0,42,42,37.5681827453,127.0456033009
04842,청계장원아파트,1,75,76,37.5693427411,127.0448455263
04843,옥수교회,2,57,59,37.5452371461,127.016009017
04844,텐즈힐아파트107동앞,29,34,63,37.5695685824,127.0285144783
04845,응봉동현대아파트,80,193,273,37.5498619578,127.0309380064
04846,논골.대림아파트107동.금호동벽산아파트,9,259,268,37.5558963995,127.0249544273
04847,옥수역5.6번출구,264,9,273,37.5418537549,127.0169983806
04848,서울숲푸르지오아파트,128,164,292,37.5450150995,127.0237432904
04849,언더스탠드에비뉴,7,44,51,37.543572,127.042776
04850,성동구민종합체육센터,108,67,175,37.545138,127.044474
04852,경일중고등학교,12,64,76,37.542316,127.049131
04854,이마트.서울숲힐스테이트아파트,2,10,12,37.540121,127.052284
04855,서울숲코오롱디지털타워2차,7,60,67,37.541411,127.05399
04856,서울경찰청제6기동단,24,26,50,37.540076,127.054739
04857,한라시그마밸리앞,42,61,103,37.539647,127.05532
04858,성수역3번출구,73,167,240,37.543842,127.057061
04859,서울숲코오롱디지털타워2차,82,8,90,37.541461,127.053848
04860,이마트.서울숲힐스테이트아파트,6,3,9,37.540528,127.05257
04861,현대그린아파트,17,11,28,37.540523,127.049622
04862,성수역3번출구,184,18,202,37.5435598293,127.0566906693
04863,경일중고등학교,55,13,68,37.542503,127.04921
04864,한라시그마밸리,19,65,84,37.5399060735,127.0551786364
04865,서울경찰청제6기동단,38,16,54,37.540228157,127.0547711849
04866,서울숲역,20,79,99,37.543869,127.045146
04867,성동구민종합체육센터,65,62,127,37.54527,127.044515
04868,서울숲2번출입구,28,18,46,37.543527,127.04255
04871,서울숲9번출입구,5,22,27,37.5436374894,127.03755914
04872,옥수역4번출구,1267,1692,2959,37.5418118508,127.0176124993
04873,성수대교북단교차로,12,54,66,37.5442958508,127.0355169956
04876,마장역,30,12,42,37.5661140833,127.0426522462
04877,마장역,49,52,101,37.5656474129,127.0423947542
04878,옥정초등학교,1,123,124,37.5408892401,127.015419565
04879,e편한세상금호109동,1,43,44,37.5534825943,127.0218758358
04883,왕십리자이아파트107동,0,68,68,37.5597128375,127.0259692914
04884,왕십리KCC스위첸아파트,159,101,260,37.5603742034,127.0268266814
04885,금호베스트빌아파트노인정앞,29,51,80,37.5618733218,127.025069533
04886,풍림아이원아파트후문,1,46,47,37.5601942456,127.0268499549
04887,응봉역.광희중학교,58,64,122,37.5518786122,127.0352978775
04888,대림강변타운아파트A상가,60,59,119,37.5547901705,127.0357171978
04889,리버그린동아아파트정문,128,5,133,37.5534932401,127.0375237372
04890,서울숲리버뷰자이아파트제2주차장,44,9,53,37.5561652703,127.0394073408
04891,서울숲리버뷰자이아파트제2주차장,10,87,97,37.5557215716,127.0392797867
04892,서울숲리버뷰자이아파트제1주차장,2,49,51,37.5541970798,127.0388889816
04893,왕십리로교차로,1,53,54,37.557719765,127.0389354428
04894,왕십리로교차로,0,21,21,37.5577676066,127.0391339263
04895,리버그린동아아파트,1,142,143,37.553344391,127.0382720735
04896,서울숲리버뷰자이아파트제1주차장,30,5,35,37.5545097441,127.0392367112
04897,왕십리역6-1번출구,623,231,854,37.5607923799,127.0379129532
04898,행당동서울숲더샵,21,41,62,37.5578072325,127.0397222715
04899,행당동서울숲더샵,22,53,75,37.5580008839,127.0399091167
04904,한양대학교병원본관1층,9,210,219,37.559459871,127.0438016174
04905,한양대학교병원본관1층,39,12,51,37.5594516108,127.0435712108
04906,한양대학교병원응급실,19,237,256,37.5598124622,127.0445985625
04907,한양대학교류마티스병원동관,147,1,148,37.5599701163,127.044652417
04908,한양대학교백남학술정보관,15,184,199,37.5589963484,127.0446277378
04909,한양종합기술연구원.생활과학대학,106,3,109,37.5590603809,127.0449123153
04910,한양대학교생활과학대학,3,81,84,37.5568034886,127.0465028779
04912,한양대학교제2의학관,57,40,97,37.5593313351,127.0421309686
04914,한양대학교정문,160,24,184,37.5577761117,127.0421228179
05001,군자교입구,1780,1556,3336,37.5587409868,127.0756461481
05002,군자교입구,1327,1722,3049,37.5587937258,127.0749002776
05003,군자역.용마초등학교,1111,1249,2360,37.5560989145,127.082473132
05004,군자역.용마초등학교,1865,1619,3484,37.5562698192,127.081556441
05005,중곡동입구삼거리,920,1028,1948,37.5544965543,127.086550509
05006,어린이대공원후문아차산역,1678,1738,3416,37.5512084718,127.0901491873
05007,어린이대공원후문아차산역,2581,2345,4926,37.5527548961,127.0892141692
05008,중곡동입구삼거리,729,912,1641,37.554926,127.085229
05009,새밭교회,267,443,710,37.5489834052,127.0931845435
05010,새밭교회,425,599,1024,37.548957926,127.0926144514
05011,광나루역,1211,565,1776,37.5457409721,127.1026490566
05012,광나루역,498,1145,1643,37.5451588569,127.1037600333
05101,군자교,171,261,432,37.561532857,127.0752029849
05102,군자교,141,91,232,37.5623861756,127.0752287457
05103,메리놀외방선교회,246,316,562,37.5589508735,127.0773349708
05104,메리놀외방선교회,502,308,810,37.559086619,127.0776318627
05105,중곡1동주민센터입구,85,309,394,37.5605224214,127.0783835194
05106,중곡1동주민센터입구,207,217,424,37.5608783017,127.078403699
05107,중곡1동사거리,137,450,587,37.5624536807,127.0794725244
05108,중곡1동사거리,403,123,526,37.5624813464,127.0792818001
05109,중마초등학교.중곡제일골목시장앞,294,265,559,37.5649806937,127.0808443646
05111,용마사거리,433,158,591,37.5622907455,127.0818720972
05112,중곡2동주민센터앞,562,319,881,37.5598837254,127.0808552636
05113,중곡2동주민센터앞,327,638,965,37.5598402672,127.0811551751
05114,중곡동성당앞,193,371,564,37.5631682406,127.0829363287
05115,종합의료복합단지,101,177,278,37.5638882429,127.0833601348
05116,대원여자고등학교앞,1071,371,1442,37.562118,127.087052
05117,중곡보건지소,261,213,474,37.5599194877,127.0869845748
05118,신성시장앞,1171,606,1777,37.5583163621,127.0876755037
05119,중곡우체국앞,122,190,312,37.5615773116,127.0838852989
05120,면곡시장,194,237,431,37.569746048,127.0797293274
05121,면곡시장,321,164,485,37.5700272219,127.0794405363
05122,중곡아파트,226,377,603,37.5664012264,127.0778996992
05123,중곡아파트,264,177,441,37.5657955541,127.0771769652
05124,중마초등학교.중곡제일골목시장앞,684,200,884,37.5652307141,127.0808531239
05125,중곡역입구,133,247,380,37.5663404337,127.0816150335
05126,중곡역입구,445,276,721,37.5666597846,127.0816481504
05127,중곡3동주민센터앞,157,236,393,37.5685360222,127.0827951289
05128,중곡3동주민센터앞,650,279,929,37.5684915275,127.0826418853
05129,면곡시장앞,499,325,824,37.5707949236,127.0832843745
05130,면곡시장앞,134,156,290,37.5710831259,127.0834488311
05131,용암사입구,503,397,900,37.5679159934,127.0860566161
05132,용곡삼거리,157,322,479,37.5679334531,127.0855902354
05133,중곡역.국립정신건강센터,303,255,558,37.5660464177,127.0845454928
05134,대원고교앞,631,315,946,37.5639660286,127.086708621
05135,용암사입구,162,346,508,37.5678680041,127.0863735321
05136,대원고교앞,221,326,547,37.5641992207,127.0869681157
05137,대원여자고등학교앞,216,645,861,37.5626950451,127.0873093515
05138,신성시장,630,792,1422,37.5583189468,127.0879297616
05139,중곡동입구,689,935,1624,37.5541967204,127.0886689538
05140,어린이대공원앞,674,931,1605,37.5520458638,127.0770314953
05141,능동사거리.군자역6번출구,910,1253,2163,37.5551766839,127.0786346746
05142,구의사거리.광진소방서앞,420,138,558,37.545249575,127.083977653
05143,어린이회관,244,268,512,37.545612,127.079201
05144,구의사거리.광진소방서앞,156,570,726,37.5449986565,127.0843023754
05145,광진경찰서,1709,1637,3346,37.5415336614,127.0836883111
05146,광진경찰서,1029,457,1486,37.5430873683,127.0846474366
05147,광진경찰서,358,269,627,37.5422101065,127.0842426589
05148,광진구청,1768,1382,3150,37.5389648482,127.0834073669
05149,구의역2번출구,1820,1049,2869,37.5377026867,127.0879772581
05150,래미안구의파크스위트,349,493,842,37.5447158904,127.0890122213
05151,구의2동주민센터입구,738,575,1313,37.5492515718,127.0897846677
05152,구의2동주민센터입구,562,1038,1600,37.5486416815,127.08958588
05153,구의사거리,562,952,1514,37.5456510932,127.0857469566
05154,구의사거리,899,662,1561,37.5458173579,127.0863480831
05155,래미안구의파크스위트,524,266,790,37.5449638155,127.0890507143
05157,현대아파트앞,363,165,528,37.539643765,127.0941742917
05158,광진우체국,138,329,467,37.537998,127.090409
05162,테크노마트앞.강변역,1179,713,1892,37.5368645137,127.0937549878
05163,구의현대2단지아파트,111,404,515,37.5378533679,127.0965424639
05164,올림픽대교북단사거리,373,398,771,37.5433926994,127.0932099949
05165,올림픽대교북단사거리,544,468,1012,37.5433887171,127.0936875546
05166,광장동현대아파트앞,590,181,771,37.541909114,127.0977640864
05167,광장동현대아파트앞,93,565,658,37.54207254,127.0989722091
05168,광나루역.극동아파트,63,521,584,37.5435355041,127.1029628675
05169,광나루역.극동아파트,1069,137,1206,37.5442424761,127.1033202823
05170,어린이대공원역2번출구,396,959,1355,37.546984,127.075378
05175,광진구청,1087,1915,3002,37.5387627825,127.0831891894
05176,자양사거리,813,330,1143,37.5369337778,127.0824320547
05177,자양사거리,272,602,874,37.5367503042,127.0821044683
05178,자양초등학교앞,396,307,703,37.5379478514,127.0784673729
05179,자양초등학교앞,258,416,674,37.5374228649,127.0792651176
05180,건국대학교앞,530,1126,1656,37.5387452063,127.0750483076
05181,국가기록원성남분원.코이카,0,23,23,,
05182,국가기록원성남분원.코이카,19,2,21,,
05183,자양미소약국.자양골목시장,460,808,1268,37.53275,127.077319
05185,자양동우체국.중앙농협,587,1234,1821,37.531572725,127.081413066
05187,자양하늘채베르아파트앞,524,890,1414,37.5321922367,127.0846079653
05188,자양동잠실대교북단,1364,1147,2511,37.5329553244,127.0848057104
05189,신자초등학교앞,900,180,1080,37.5304403173,127.0749155368
05190,자양미소약국.자양골목시장,1206,590,1796,37.5327003382,127.0768712862
05191,자양동우체국.중앙농협,1543,654,2197,37.5315308364,127.0807386521
05192,동서울우편집중국앞,574,921,1495,37.5350521104,127.084337729
05193,자양하늘채베르아파트앞,1205,515,1720,37.5319732231,127.0846733447
05194,자양동잠실대교북단,811,1255,2066,37.5321201527,127.0858514017
05195,자양2동주민센터,153,55,208,37.527949,127.08517
05196,구립행복마루어린이집,229,35,264,37.527743,127.082213
05197,자양한강도서관,181,16,197,37.528429,127.078333
05199,구의역3번출구,988,1283,2271,37.5375186301,127.0882893582
05200,국민은행신자양지점,479,344,823,37.5355719112,127.066874712
05201,신양초등학교앞,202,353,555,37.5349118182,127.0692877009
05202,신양초등학교앞,205,81,286,37.535233709,127.0689474032
05203,뚝도변전소앞,529,752,1281,37.5360909985,127.0689075815
05204,광진문화예술회관,2143,1562,3705,37.5385652456,127.0701692006
05205,복정파출소.복정캠퍼스맛집거리,1788,934,2722,37.5384461141,127.0748753929
05209,신자초등학교앞,1,585,586,37.530768,127.074922
05210,자양우성아파트앞,164,561,725,37.5337952382,127.0734112939
05211,자양우성아파트앞,640,144,784,37.533946958,127.0734066984
05212,자양고교앞,501,248,749,37.5345790942,127.0711714016
05213,자양고교앞,207,590,797,37.53431586,127.0713601174
05214,대동아파트앞,222,479,701,37.536419,127.068967
05215,국민은행신자양지점,485,516,1001,37.5357293289,127.0672016099
05216,영동교골목시장,984,881,1865,37.5395029881,127.0626912618
05217,건대입구역6번출구,998,1552,2550,37.5408268775,127.0672788711
05218,건대로데오거리입구,2183,1764,3947,37.539081,127.070158
05219,노룬산시장앞,431,511,942,37.5368058708,127.0629447386
05220,영동대교북단,1155,2180,3335,37.5367146879,127.0611888361
05221,노룬산시장앞,573,324,897,37.5366067526,127.0628993085
05222,신양초등학교앞,340,38,378,37.5338028399,127.0679166913
05223,자양4동주민센터앞,50,195,245,37.533632,127.067497
05224,성수사거리,509,418,927,37.5431585111,127.0647765888
05225,화양사거리,584,541,1125,37.5472318425,127.0670885688
05226,광진광장,876,593,1469,37.5477151717,127.0715209148
05227,어린이대공원역4번출구,1230,1447,2677,37.5466216409,127.0736284938
05228,한아름공원,432,1126,1558,37.543765,127.072222
05229,건대입구역사거리.건대병원,479,2084,2563,37.548983,127.093185
05230,건대입구역1번출구,1455,417,1872,37.5408957525,127.0681672642
05231,어린이대공원역3번출구,1114,526,1640,37.5468045831,127.0751469149
05232,건대입구역사거리.건대병원,4893,2342,7235,37.5408198597,127.071248506
05233,어린이회관,132,446,578,37.5452722228,127.079595313
05234,천주교화양동성당,1040,1706,2746,37.5459043941,127.0735881785
05235,송정동서울숲아이파크,409,514,923,37.5517044591,127.0695975111
05236,송정동건영아파트,412,423,835,37.5547537734,127.0712985506
05237,군자교남단,73,134,207,37.557410967,127.0727879339
05238,중앙농협군자지점,552,193,745,37.5577085489,127.0767090775
05239,중앙농협군자지점,254,556,810,37.5571562758,127.0765591034
05240,능동우편취급국,92,313,405,37.5561609072,127.0760329007
05241,군자삼거리,333,208,541,37.5549755455,127.0752869423
05242,군자삼거리,123,220,343,37.5546466232,127.0753228303
05243,세종초등학교.세종사이버대학교앞,629,325,954,37.5535248785,127.0733966913
05244,세종초교앞,256,422,678,37.5538666538,127.0743618087
05245,군자새마을금고.성동광진위센터,420,464,884,37.5518512093,127.0713225073
05246,군자새마을금고앞,482,405,887,37.5513566499,127.0710877554
05247,장안초등학교,807,478,1285,37.5486923124,127.070754754
05248,장안초등학교,360,419,779,37.5485801736,127.0704835547
05249,화양사거리,985,735,1720,37.5483288986,127.0686841693
05250,광진광장,1092,1190,2282,37.5480051511,127.0715410787
05251,어린이대공원앞.세종대학교,334,443,777,37.549752,127.07544
05252,능동교회앞,603,518,1121,37.5528739948,127.0769927342
05253,능동사거리.군자역7번출구,1601,1906,3507,37.556322,127.07882
05256,아차산역삼거리,160,402,562,37.554581226,127.0867859773
05257,용마초등학교,255,617,872,37.5565422552,127.081723671
05258,어린이대공원후문,996,661,1657,37.5508666828,127.0905075507
05259,서울화양동우체국,471,500,971,37.5481104097,127.0687743625
05260,중곡동입구,447,775,1222,37.554798956,127.0882622041
05261,제일은행사거리,466,27,493,37.5335505333,127.0747505569
05262,동곡삼거리,103,32,135,37.5636739408,127.0779538856
05263,건대병원입구,649,467,1116,37.5421084758,127.0714727877
05265,광진청소년센터,181,185,366,37.5459514944,127.1053745185
05267,테크노마트앞.강변역,599,694,1293,37.5369050205,127.0938031252
05268,중곡동성당,36,20,56,37.5627654195,127.0824010859
05269,종합의료복합단지,25,16,41,37.564373065,127.0833026919
05270,중곡역.국립정신건강센터,33,35,68,37.5662294972,127.0843249567
05271,용곡삼거리,1,0,1,37.5685782991,127.0855997978
05272,구의3동주민센터,273,545,818,37.5390684116,127.0925470575
05273,구의3동주민센터,635,552,1187,37.5390484885,127.0921000962
05298,광진구민체육센터,186,189,375,37.5469081131,127.1078574657
05299,광나루우편취급국,172,50,222,37.5474023285,127.1063092687
05499,건대입구,50,875,925,37.5401911408,127.0709898289
05500,중곡4동경로당입구앞,47,1,48,37.5591306198,127.0939630731
05501,중곡아파트.종점,0,39,39,37.5663789768,127.0779156425
05503,긴고랑종점,69,29,98,37.562194465,127.0960429247
05504,정보도서관,319,130,449,37.5502486719,127.1104622298
05505,강원설비앞,77,9,86,37.5590029448,127.0901359394
05506,강원설비앞,3,49,52,37.5588490108,127.0899354071
05508,중앙상회앞,172,0,172,37.5601590013,127.0947974601
05509,한강호텔입구,53,1,54,37.5484546316,127.1094523282
05510,중곡4동경로당입구앞,2,53,55,37.5591925416,127.0942812172
05511,중곡아파트.기점,78,128,206,37.5668768426,127.0781637961
05512,구.새마을금고앞,34,1,35,37.5614417271,127.0871709238
05513,CU중곡긴고랑점앞,115,0,115,37.5589159963,127.0930312463
05514,광나루현대아파트,92,20,112,37.546721738,127.1075869834
05515,긴고랑주차장,43,0,43,37.5609606399,127.0956309346
05517,신성시장입구,281,17,298,37.5585269693,127.0880096605
05518,중곡4동어린이집입구,75,0,75,37.5586845522,127.0917043706
05519,신동아아파트,60,125,185,37.5463512912,127.105328946
05522,새마을금고.브레드제과점,146,19,165,37.5576339581,127.0892468924
05523,긴고랑입구,39,22,61,37.5588770015,127.0886688403
05527,우리들약국,211,31,242,37.5569014807,127.0902850791
05528,광남고.삼성아파트,239,72,311,37.5419477863,127.1014183009
05531,해오름공원입구,193,45,238,37.5563079173,127.0911230749
05533,현대3차아파트,256,83,339,37.5404651876,127.0996486938
05535,기업은행.용마사거리,206,29,235,37.5624460371,127.0814330674
05536,기원정사입구,408,106,514,37.5548826175,127.0931371525
05539,송림식당앞,83,170,253,37.5368221134,127.0766299665
05540,중곡우체국앞,148,88,236,37.5611637445,127.0840577691
05541,영화사입구,217,57,274,37.5542285469,127.0941176381
05542,군자역,373,135,508,37.5578748138,127.0800822765
05543,강변역.테크노마트앞,182,534,716,37.5363934727,127.0948590232
05544,자양중학교앞,118,175,293,37.5346905273,127.0759963869
05545,성안약국,129,29,158,37.5532100607,127.0932969209
05549,지영슈퍼,162,90,252,37.5518187362,127.0921939479
05550,구의역,342,129,471,37.5382387949,127.0892373497
05551,국민은행자양지점,171,390,561,37.5319860054,127.0792387772
05553,아차산역사거리,212,132,344,37.5507215451,127.0913081489
05554,중곡보건지소,131,129,260,37.5595305795,127.0870747483
05555,썬더치킨앞,54,124,178,37.5415506336,127.0900164716
05556,영동대교입구.성수사거리,39,86,125,37.5428255093,127.064525855
05558,선화예고앞,284,107,391,37.5494847466,127.0900588338
05559,긴고랑입구,44,63,107,37.5587364311,127.0886686737
05560,구의홈마트앞,42,61,103,37.5402902234,127.0897229975
05561,화양동현대아파트,8,93,101,37.5439827587,127.0652401586
05562,성자초등학교앞,231,318,549,37.5313000096,127.0822557273
05563,한국켄트외국인학교,284,201,485,37.5477299911,127.0880988204
05564,중곡4동어린이집입구,1,67,68,37.5585169771,127.0916679445
05565,래미안구의파크스위트사거리,63,136,199,37.5440489261,127.0906000271
05566,성수대우프레시아1차아파트,12,374,386,37.5452943403,127.0659848276
05569,CU중곡긴고랑점앞,2,71,73,37.5587592285,127.0930027538
05571,화양사거리성수SKV1센터,8,122,130,37.546257958,127.0664104572
05572,행운슈퍼앞,100,170,270,37.5329501167,127.0870098898
05574,중앙상회앞,1,144,145,37.5601577922,127.0949721336
05576,한창주택,78,114,192,37.5336144423,127.0891356598
05578,광장중학교앞,54,176,230,37.5467903263,127.1024015366
05579,구의아크로리버앞,128,341,469,37.5352926857,127.0921362577
05580,구의역4번출구,110,1905,2015,37.5366543055,127.084837057
05581,장신대앞,13,110,123,37.5475393553,127.1052273651
05582,강변역A,1012,953,1965,37.535988,127.093833
05584,워커힐아파트입구,8,32,40,37.5478863435,127.1065941453
05585,동서울호텔앞,247,37,284,37.5345920961,127.0920490446
05587,워커힐아파트,120,133,253,37.5500035243,127.1075883052
05588,한창주택,125,94,219,37.5337153779,127.0891188071
05589,행운슈퍼앞,99,116,215,37.5330699358,127.0870462374
05591,워커힐아파트입구,47,2,49,37.5480798615,127.1065163612
05594,구의역1번출구,1548,103,1651,37.5369298571,127.084788302
05595,장신대앞,68,17,85,37.5476304504,127.1051324275
05596,성자초등학교앞,278,226,504,37.5315196593,127.0825682599
05597,광장중학교앞,146,24,170,37.5469479421,127.1024888949
05599,광진경찰서앞,448,509,957,37.542346877,127.0843546327
05600,한전삼거리,14,11,25,37.5454433478,127.097965691
05668,국민은행자양지점,324,231,555,37.5322779304,127.0790299525
05670,청구아파트앞,63,20,83,37.5423895999,127.0967938276
05671,광장자이아파트,19,36,55,37.542252836,127.0949238539
05672,서울서광교회앞,101,195,296,37.5475847263,127.088351026
05677,자양중학교앞,186,135,321,37.5346353803,127.0762758207
05679,래미안구의파크스위트사거리,246,73,319,37.5441301287,127.0904643237
05680,자양1파출소앞,187,151,338,37.5367651642,127.0769071428
05687,면곡시장,169,480,649,37.571462406,127.0813749581
05690,동곡삼거리,54,196,250,37.5638021287,127.0782624509
05709,지영슈퍼,44,164,208,37.5517744916,127.0923104685
05710,세븐일레븐구의중앙로점앞,124,29,153,37.5415633601,127.089870505
05713,성안약국,45,215,260,37.5531415024,127.0933919081
05714,구의홈마트앞,31,98,129,37.5403191787,127.089564605
05716,종로약국앞,91,221,312,37.5575879581,127.0881058981
05717,영화사입구,74,285,359,37.5540834447,127.0941502787
05718,구의역,72,413,485,37.5382758492,127.08909255
05720,기원정사입구,116,366,482,37.5551737566,127.0930355787
05721,테크노마트.광진문화원,522,89,611,37.5370205329,127.0961011535
05723,해오름공원입구,76,227,303,37.5563302584,127.0913641894
05724,프라임아파트앞,55,53,108,37.5378379672,127.0970323661
05726,용마사거리,2,169,171,37.5627570449,127.0812432362
05727,우리들약국,40,104,144,37.5570437893,127.0903690097
05728,현대3.5차아파트,55,179,234,37.5407790748,127.1003518538
05731,새마을금고앞,25,124,149,37.5577311656,127.0893930217
05732,광남고.삼성아파트,28,180,208,37.5423430827,127.1017492793
05733,자양종합복지관앞,1,321,322,37.5324649901,127.075429514
05735,신성시장입구,56,159,215,37.5586702034,127.0880630283
05737,대순진리회앞.구.새마을금고,17,148,165,37.5609548433,127.0875676658
05739,대원외고앞,0,201,201,37.5632448358,127.0871413296
05740,광나루현대아파트,3,72,75,37.5466936524,127.1077533058
05741,중곡4동파출소,0,103,103,37.5654194455,127.0867703018
05742,한강호텔입구,0,71,71,37.5482745397,127.1093151239
05744,워커힐팰리스,0,116,116,37.5500133218,127.1096719072
05752,아차산역사거리,154,279,433,37.5506719315,127.0914351492
05755,중곡119안전센터,11,2,13,37.5667567645,127.0862442255
05757,구의3동주민센터,194,70,264,37.5380104633,127.0916151163
05990,광장자이아파트,44,37,81,37.5421672546,127.0949108596
05992,한전삼거리,0,44,44,37.5452405574,127.0980186154
05993,청구아파트앞,16,65,81,37.5432605587,127.0961815897
05994,용마사거리,10,22,32,37.5618532936,127.0822104997
05998,구의교통차고지,38,29,67,37.562731,127.086994
05999,강변역.테크노마트앞,743,838,1581,37.5363411077,127.0947896041
06001,답십리역사거리,1671,1003,2674,37.5651870868,127.0550604632
06002,청년회의소,1744,1214,2958,37.5619653169,127.0612838214
06003,장한평역,1907,2188,4095,37.5611510646,127.0672869559
06004,신답초등학교.청계한신휴플러스,442,687,1129,37.571753,127.044292
06005,신답초등학교.청계한신휴플러스,639,874,1513,37.5717559096,127.0447281029
06006,동대문구청,731,1097,1828,37.5740954485,127.038327222
06007,서울시동부병원,866,1137,2003,37.5739292519,127.0309536211
06008,신설동역.서울풍물시장,719,1586,2305,37.574427911,127.0257176822
06009,중랑교,1738,2028,3766,37.5916996082,127.0677039967
06010,중랑교,1828,1465,3293,37.5914246178,127.0668383757
06011,삼육서울병원,1984,2003,3987,37.589691279,127.0606858682
06012,삼육서울병원,2285,2093,4378,37.589992454,127.0619514091
06013,시조사삼거리,880,1111,1991,37.588707,127.056888
06014,떡전교사거리.동대문노인복지관,1983,2112,4095,37.5864439121,127.0520111918
06015,청량리역환승센타,5155,7128,12283,37.5804025104,127.0454307288
06016,청량리역환승센타,1648,1110,2758,37.5802508767,127.0460771387
06017,동대문구청,995,622,1617,37.5734588708,127.0399889148
06018,청량리역환승센터,3457,1500,4957,37.5802240706,127.0457513342
06019,청량리역환승센터,6331,3055,9386,37.5803029185,127.0457230797
06020,청량리역환승센터,2028,1793,3821,37.5807152606,127.0453667154
06021,청량리미주아파트.동대문세무서,1429,2670,4099,37.58278,127.048395
06022,청량리.청과물도매시장,3819,3676,7495,37.5787911202,127.0406051232
06023,제기동역.서울약령시,2682,2969,5651,37.5781433423,127.0377802394
06024,제기동역.서울약령시,2580,2476,5056,37.5782136235,127.036575079
06025,용두동사거리,1571,1763,3334,37.5775320632,127.0299882252
06026,용두동사거리.한국의류시험연구원,1274,1444,2718,37.5771526546,127.0282789088
06027,신설동역,1899,1902,3801,37.5761500409,127.0250446359
06028,신설동역,925,1627,2552,37.575826798,127.0238433051
06101,신설동역,859,950,1809,37.576453593,127.0255836506
06102,신설동역,957,631,1588,37.5762453617,127.025947005
06103,용두동한국의류시험연구원,103,229,332,37.5775187657,127.029114172
06104,용두로타리한국의류시험연구원,220,114,334,37.5772564569,127.0294820292
06106,제기역약령시장,385,173,558,37.5780535417,127.0368349109
06107,신설동역1번출구,2362,1379,3741,37.5766303332,127.0233166791
06112,청량리미주상가앞,69,116,185,37.5818902252,127.0476780218
06113,서울성심병원,418,807,1225,37.5843923886,127.0502442553
06114,서울성심병원,3119,2399,5518,37.5846074691,127.0508977332
06115,시조사,6,64,70,37.5868487759,127.0522795666
06117,휘경동입구,1016,1535,2551,37.5876644832,127.0552071034
06118,삼육서울병원,159,747,906,37.5897656487,127.0606123322
06120,래미안라그란데아파트,903,309,1212,37.600355,127.06193
06121,중랑교,386,215,601,37.59114436,127.0664306844
06122,회기시장,1188,1315,2503,37.5912026288,127.0566389299
06123,회기시장,1748,1404,3152,37.5908060401,127.0565879609
06124,경희중고,820,925,1745,37.5929228111,127.0577445104
06125,경희중고,499,1062,1561,37.5933472946,127.0583346646
06126,외대앞,2169,1026,3195,37.5956282146,127.0596059335
06127,외대앞,1198,1893,3091,37.5954812555,127.0597677578
06128,이문동우체국,557,398,955,37.598348,127.061338
06129,이문동교회,433,1104,1537,37.6002569171,127.0621071328
06130,의릉입구,787,381,1168,37.603888,127.061963
06131,의릉입구,385,768,1153,37.6034852714,127.0621763625
06132,한천로쌍용아파트앞,352,142,494,37.5981910949,127.0676192785
06133,한천로쌍용아파트앞,181,335,516,37.5986649133,127.0678869789
06134,이문동삼익아파트,494,322,816,37.5945485558,127.0682139128
06135,이문동삼익아파트,136,294,430,37.5951035399,127.0683627707
06136,동일스위트리버아파트.휘봉고교,488,707,1195,37.5877987669,127.0677525508
06137,휘경유수지견인차고지앞,115,127,242,37.58842,127.068577
06138,답십리래미안엘파인아파트,161,93,254,37.5756772295,127.067330886
06140,서울준법지원센터.동성빌라,298,615,913,37.5855552625,127.0673893111
06141,서울준법지원센터.동성빌라,424,348,772,37.5856794521,127.0676702359
06142,휘경여중고휘경주공아파트앞,1263,1487,2750,37.5826030732,127.0682824634
06143,휘경여중고휘경주공아파트,1257,869,2126,37.5821574897,127.0685434142
06144,장안동현대아파트앞,942,1076,2018,37.5797461738,127.0685412036
06145,전곡시장앞,663,360,1023,37.5772370675,127.06779506
06146,전곡시장앞,436,455,891,37.5773293235,127.0681419969
06147,답십리촬영소.우성그린아파트,507,402,909,37.5741908611,127.0668512705
06148,촬영소사거리.우성그린아파트,460,543,1003,37.5735106563,127.0669165487
06149,동답초등학교,498,650,1148,37.5710397628,127.065489039
06150,동답한신동아아파트,1161,486,1647,37.5696220827,127.0641135329
06151,동답한신동아아파트,521,770,1291,37.568881615,127.0639045358
06152,동아.위더스빌아파트,765,1204,1969,37.5667402906,127.0622143149
06153,동아.위더스빌아파트,918,619,1537,37.566603,127.06181
06154,하나은행장안동지점,369,740,1109,37.5634035936,127.0585564607
06155,장한평역4번출구,1776,1281,3057,37.5613115442,127.067137684
06156,청년회의소앞,641,690,1331,37.5621102645,127.0615307058
06157,고미술상가,270,766,1036,37.563609188,127.0572974308
06158,답십리역.동부시장,1373,2513,3886,37.5672562517,127.0525194449
06159,신답역앞,504,434,938,37.5708430857,127.0470913509
06160,동대문구청.용두역4번출구,667,511,1178,37.5734350116,127.0397135905
06161,용두역,395,452,847,37.573977,127.037268
06162,용두동신동아아파트,908,789,1697,37.5737704369,127.0317924634
06163,동대문우체국.서울풍물시장,1350,594,1944,37.574759758,127.0245652731
06164,동대문구청.용두역3번출구,962,859,1821,37.5755374598,127.0383451914
06165,동대문구청.용신동주민센터,891,1510,2401,37.5765807726,127.0384168651
06166,동대문구청.용신동주민센터,1014,975,1989,37.5753096484,127.0379882341
06167,경동시장앞,955,679,1634,37.5819989191,127.0387559286
06168,성남시청후문앞,579,791,1370,37.5819251477,127.0383947016
06169,경동시장,1270,1117,2387,37.5799644113,127.038283869
06170,홍파초등학교,513,723,1236,37.585531,127.038639
06171,홍파초등학교,1397,1155,2552,37.5855971074,127.0383377075
06172,제기동한신아파트앞,496,756,1252,37.587603,127.037888
06173,고려대역.고대앞삼거리,1630,1386,3016,37.5894337656,127.0366856036
06174,고려대역.고대앞삼거리,1296,1315,2611,37.5887478517,127.0366498479
06175,고려대학교앞,2315,1898,4213,37.5881363102,127.0346801536
06176,우신향병원,659,725,1384,37.5857223011,127.0323863454
06177,안암오거리,902,1084,1986,37.5824613624,127.0298970499
06178,대광고등학교앞,508,676,1184,37.5797777214,127.0255621436
06179,종암초등학교앞,365,374,739,37.5816186068,127.0295992386
06180,샤니.삼영전자,324,307,631,37.5791115868,127.0303341829
06181,샤니후문,173,407,580,37.579035,127.030161
06182,서울시동부병원,946,871,1817,37.5758964701,127.0304302445
06183,서울시동부병원,639,549,1188,37.5761901571,127.0306952909
06184,동아제약앞,905,546,1451,37.5725993738,127.0304424882
06185,동아제약앞,813,954,1767,37.5727164409,127.0307312249
06186,떡전교앞,899,957,1856,37.5849040401,127.0526948922
06187,떡전교앞,1399,1305,2704,37.5846184473,127.0525769324
06188,서울시립대입구,1299,1256,2555,37.5830057298,127.0540556741
06189,서울시립대학교앞,1084,1457,2541,37.5826804893,127.053939948
06190,서울시동부교육지원청.해성국제컨벤션고교,1592,983,2575,37.5791853497,127.0568650184
06191,전농로터리시장.동부교육지원청,991,1398,2389,37.578817,127.05676
06192,전농우체국앞,968,974,1942,37.576367,127.057575
06193,전농우체국앞,940,615,1555,37.5765201613,127.0578903291
06194,청솔우성아파트.답십리시장,932,977,1909,37.5737092806,127.0576479903
06195,미드카운티아파트.청솔우성아파트,1252,945,2197,37.5741112935,127.0573890413
06196,답십리2동시온교회앞,611,490,1101,37.5705961302,127.0573999289
06197,답십리1동희망샘교회앞,726,495,1221,37.5705241856,127.0571055329
06198,답십리초등학교.현대시장,927,589,1516,37.568453856,127.0572012663
06199,답십리초등학교앞,398,608,1006,37.5686265703,127.0569308801
06200,답십리역사거리,2067,780,2847,37.5655060079,127.0552010664
06201,황물로사거리,271,993,1264,37.5665418919,127.0559919809
06202,답십리1동주민센터.래미안위브,661,411,1072,37.5723670085,127.0510037445
06203,답십리1동주민센터.래미안위브,725,1046,1771,37.5720993946,127.0511402741
06204,동대문중학교,663,349,1012,37.5750129513,127.0537544246
06205,동대문중학교,484,987,1471,37.5741762971,127.0532771747
06206,전농래미안크레시티아파트,950,578,1528,37.5762802499,127.0555920845
06207,대한노인회동대문구지회,769,868,1637,37.5762111791,127.0559030771
06208,전농사거리,304,460,764,37.5778147722,127.0590375541
06209,전농사거리,724,827,1551,37.5775633596,127.059240552
06210,배봉초등학교.전농우성아파트,1239,516,1755,37.5786953183,127.0672948159
06211,배봉초등학교.전농우성아파트,486,1182,1668,37.5784402407,127.0674157317
06212,장안2동주민센터,1394,1235,2629,37.5788403828,127.0704039846
06213,장안2동주민센터,1628,1339,2967,37.5786959839,127.0704638197
06214,장안교앞,697,1018,1715,37.5796533965,127.0739714006
06215,장안교은석초등학교,828,540,1368,37.5796191566,127.0746902496
06216,청량리역6번출구,229,1813,2042,37.578083,127.043803
06217,청량리역6번출구,843,258,1101,37.577945301,127.043785792
06218,롯데캐슬노블레스,642,627,1269,37.5755552627,127.0484716502
06219,전농시장앞,298,600,898,37.5760847235,127.0471184271
06220,래미안크레시티.답십리도서관,700,442,1142,37.574561753,127.0502439795
06221,동대문구답십리도서관앞,340,534,874,37.573881303,127.051026821
06222,답십리래미안위브아파트,84,242,326,37.5727689807,127.0548282074
06223,답십리래미안미드카운티,433,175,608,37.57298,127.055558
06224,답십리종합상가,151,238,389,37.5727320519,127.0567075826
06225,성남시청후면,735,709,1444,37.572753697,127.0585128409
06226,한양아파트.청솔우성아파트후문,328,358,686,37.5729536188,127.0587580146
06227,답십리2동한양아파트앞,220,408,628,37.5726702291,127.0614069359
06228,답십리2동한양아파트앞,153,326,479,37.5729573511,127.0611222564
06229,동답한신.대림아파트동대문체육관,143,473,616,37.572663,127.063768
06230,촬영소사거리.동답초등학교,185,464,649,37.572642,127.065212
06231,촬영소사거리.세양청마루아파트앞,477,266,743,37.5728897611,127.0653558711
06232,동대문구.성동구선거관리위원회,401,831,1232,37.5724872082,127.0682024772
06233,동대문구.성동구선거관리위원회,400,203,603,37.5727734631,127.0678744595
06234,장안사거리,807,418,1225,37.5725845345,127.070338726
06235,국민은행장안동지점,1852,1269,3121,37.5723759111,127.0734972565
06236,국민은행장안동지점,998,906,1904,37.5720533595,127.0742100898
06237,장안동근린공원,591,371,962,37.5773238141,127.0719536475
06238,장안동근린공원,248,574,822,37.5783141497,127.0723879948
06239,동대문더퍼스트데시앙아파트,702,566,1268,37.574992107,127.0717763134
06240,NH농협장안평지점,702,671,1373,37.5751529569,127.0721655351
06241,코리아병원,518,560,1078,37.5732069079,127.0716598633
06242,새서울병원,876,856,1732,37.5731012702,127.0720050585
06243,장안동삼성쉐르빌아파트,253,1005,1258,37.5713996448,127.0713568649
06244,장안동삼성쉐르빌아파트,2066,688,2754,37.571238,127.070843
06245,힐스테이트장안센트럴,237,1030,1267,37.569605,127.070183
06246,현대벤처빌.현대썬앤빌,2240,616,2856,37.5689208635,127.0694007013
06247,현대벤처빌,329,1247,1576,37.5682414609,127.0692809071
06248,우리은행장안지점앞,741,1744,2485,37.566393,127.067727
06249,우리은행장안지점앞,352,758,1110,37.565598658,127.0676384821
06250,북한연구소앞,254,303,557,37.5634648165,127.0661434798
06251,장한평역2번출구,1860,4531,6391,37.5622965411,127.0649278366
06252,장한평역3번출구,4471,954,5425,37.5624370636,127.0654362294
06253,신이문역,1267,1052,2319,37.6026165732,127.0679015637
06254,이문동현대아파트앞,306,557,863,37.6010179381,127.070677379
06255,이문동현대아파트,443,266,709,37.6008590191,127.0709847069
06256,휘경2동주민센터,173,654,827,37.5907361464,127.0680485017
06257,휘경2동주민센터,578,197,775,37.5905048929,127.0680858743
06258,동부아동상담소.동국대부속중고,181,68,249,37.576833541,127.0763833794
06259,장안삼성래미안2차아파트,229,80,309,37.574681581,127.0766223278
06260,장안삼성래미안2차아파트.성복교회,65,69,134,37.5728468216,127.0768144692
06261,장안현대홈타운아파트앞,66,109,175,37.5697591707,127.073388625
06262,구민회관앞,288,88,376,37.5663862675,127.073941301
06263,파라브아파트,292,194,486,37.5635828092,127.0723739757
06264,장안현대홈타운상가,190,366,556,37.571308398,127.0743786204
06265,장안현대홈타운앞,476,126,602,37.5692893642,127.0756173134
06266,장안치안센터,158,120,278,37.5679458841,127.0724996415
06267,장안치안센터,135,259,394,37.568222123,127.0727017522
06268,장평중학교,57,61,118,37.565745401,127.0709395499
06269,회기역종점,2038,1719,3757,37.5899003691,127.0588619251
06270,경희대입구,1663,1228,2891,37.5912717108,127.0530131529
06271,경희대입구,999,964,1963,37.5915831099,127.0527127306
06272,서울바이오허브,718,968,1686,37.5913878427,127.0501400812
06273,서울바이오허브,711,416,1127,37.5916089493,127.0492768654
06274,한국과학기술원.홍릉초등학교,295,163,458,37.591769,127.045747
06275,한국과학기술원.홍릉초등학교,200,611,811,37.5915445702,127.0469641413
06276,국방연구원,219,336,555,37.5914093283,127.0411809472
06277,국방연구원,358,373,731,37.5911039928,127.040058371
06278,세종대왕기념관,229,56,285,37.5898533719,127.042380198
06279,세종대왕기념관,56,115,171,37.5904615395,127.0425673859
06280,영휘원사거리.홍릉사거리,443,98,541,37.5860009275,127.0431751633
06281,영휘원사거리.홍릉사거리,133,412,545,37.586014337,127.043466176
06282,동대문경찰서,95,211,306,37.583817328,127.0438781813
06283,동대문경찰서,215,355,570,37.5835585724,127.0442607393
06284,현대코아,414,162,576,37.5818120287,127.0448733855
06285,현대코아,478,540,1018,37.5814859166,127.0446557984
06286,동대문중앙새마을금고,74,180,254,37.5831179316,127.0412131745
06287,동대문중앙새마을금고,66,17,83,37.5829869315,127.0422207161
06288,제기동주민센터앞,55,116,171,37.5829768901,127.0378676044
06289,제기동한신아파트,22,184,206,37.5866381789,127.0373610455
06290,제기시장,109,88,197,37.586385972,127.0352199679
06291,제기시장,121,230,351,37.5866248976,127.0346709609
06293,외대역앞,456,181,637,37.596009591,127.0609470779
06294,외대역앞,244,469,713,37.5960661454,127.0613604745
06295,이경시장,119,177,296,37.5952640352,127.0649927315
06297,청량리한신아파트.청량사입구,220,41,261,37.5867421008,127.0474140067
06298,전동초등학교.전농동SK아파트,806,896,1702,37.5777508201,127.060944646
06299,벽산아파트,130,146,276,37.5827562798,127.0305141879
06300,제기동천주교회,154,252,406,37.582856812,127.033571029
06301,이문동쌍용아파트,264,183,447,37.5988779848,127.0688553749
06302,이문동쌍용아파트,166,230,396,37.5988317049,127.0691211054
06303,이문1동주민센터,35,97,132,37.5978067756,127.0652559287
06304,전동초등학교.전농동SK아파트,897,760,1657,37.578119856,127.061494401
06308,한국산업인력공단서울지역본부,378,102,480,37.5837445296,127.072970655
06309,서울반도체고교.휘경주공아파트,384,261,645,37.5841657316,127.0692518943
06310,e편한세상청계센트럴포레아파트,814,442,1256,37.5708159089,127.0302942423
06311,한천로입구,60,149,209,37.5991142874,127.0673520004
06313,래미안장안1차아파트앞,119,195,314,37.5668317101,127.0720204711
06314,장평중학교앞,91,140,231,37.564958189,127.0702527994
06315,청량리미주상가앞,226,897,1123,37.5819579768,127.0472557344
06316,동대문구청.용두역,95,340,435,37.572834,127.04015
06318,종로사약국,215,241,456,37.5945213658,127.0653057725
06320,회기동현대아파트,799,735,1534,37.5891109228,127.0544608913
06321,우산빌딩앞,615,938,1553,37.588882349,127.0546770593
06322,배봉산입구,457,684,1141,37.5803416249,127.0682039807
06324,면곡시장,625,73,698,37.5716446389,127.0810660939
06330,동부아파트,75,326,401,37.5866888977,127.0452316453
06335,자동차부품상가,74,65,139,37.5645946726,127.0577756725
06349,청량리한신아파트.청량사입구,165,748,913,37.5865144976,127.0476686082
06351,SK아파트형공장,11,0,11,,
06356,장안동삼성쉐르빌아파트앞,700,1326,2026,37.5723084893,127.0702110373
06357,동대문노인종합복지관,114,181,295,37.5859460919,127.0497131121
06358,쌍용아파트,276,62,338,37.6013501097,127.0683889136
06359,쌍용아파트,0,167,167,37.6014674544,127.0685176937
06416,삼육서울병원,338,160,498,37.5902833371,127.0623612795
06417,동일스위트리버앞.휘봉고교,494,475,969,37.5871806733,127.0676591393
06418,청량리수산시장,1022,1369,2391,37.5786434462,127.0408714095
06419,휘봉초등학교,53,9,62,37.5877063782,127.0696854187
06422,휘경미소지움아파트,386,370,756,37.5909282333,127.0645643148
06423,서울반도체고교.휘경주공아파트,129,225,354,37.5844695451,127.0697135361
06424,용두동신동아아파트,131,136,267,37.5740450496,127.0325997915
06426,청량리수산시장,3959,2695,6654,37.5789521614,127.0418950942
06500,답십리역,434,10,444,37.5667684599,127.0531915243
06501,가든아파트.수사연구소,112,161,273,37.5845492166,127.0720741928
06502,회기역,5835,4397,10232,37.5901230159,127.0578476787
06503,농협답십리역지점,120,7,127,37.5684978574,127.0506963586
06504,동일하이빌.현대베스트빌아파트,90,12,102,37.5824731826,127.0739978057
06505,동안교회,24,77,101,37.593867821,127.0577430725
06506,경희대입구,18,479,497,37.5915657534,127.0527811217
06507,청계한신휴플러스아파트,420,318,738,37.571807229,127.0450335285
06508,시조사삼거리,46,94,140,37.588481,127.053504
06509,경희중고,22,110,132,37.5943592428,127.056427291
06510,경희대의료원,3337,2751,6088,37.5940620058,127.0522472422
06511,한신휴플러스정문,93,67,160,37.5727352624,127.0450796439
06512,천장산로33,30,54,84,37.598865,127.057872
06513,경희맨션,5,87,92,37.5956150844,127.0570001318
06515,동아아파트,136,105,241,37.5742471004,127.0455832239
06516,삼성래미안,124,105,229,37.600017,127.058495
06517,경희대동문,29,218,247,37.5966712234,127.0568673052
06518,래미안라그란데,146,48,194,37.59979,127.060119
06519,전농119안전센터,29,48,77,37.5761835356,127.0456081798
06520,래미안라그란데,56,278,334,37.599997,127.059674
06521,외대.경희대후문,75,181,256,37.5983128684,127.0571505475
06523,전농1동치안센터,99,89,188,37.5764222386,127.0480957022
06524,휘경여중고.휘경주공아파트,509,16,525,37.5824548381,127.0685629353
06526,신성미소지움아파트,105,126,231,37.5789318307,127.0501307614
06528,삼성래미안,114,169,283,37.5999118194,127.0573675632
06530,청량리소화물취급소,88,67,155,37.5805090878,127.0514146373
06533,영광빌딩,46,50,96,37.5818431221,127.0525059131
06537,시립대입구,50,122,172,37.5838521215,127.0534663672
06539,외대앞역,740,435,1175,37.5953348737,127.0628249067
06546,회기역종점,1188,1064,2252,37.5898517712,127.0587395905
06556,외대.경희대후문,184,78,262,37.5983039484,127.0569625455
06557,신설동역1번출구,840,147,987,37.5760124698,127.0236090065
06559,천장산로33,40,66,106,37.5988826722,127.0577550224
06560,경희대동문,137,52,189,37.5967406655,127.056746183
06564,경희맨션,21,27,48,37.5956556765,127.0569106983
06567,경희중고,82,27,109,37.5946512359,127.056342578
06570,동안교회,11,70,81,37.5928603119,127.0573015187
06572,동대부고.은석초교앞,46,114,160,37.5792594647,127.0736700296
06575,서울시립대,97,61,158,37.5831151587,127.0531816401
06576,영광빌딩,70,36,106,37.5819811249,127.0521991693
06577,청량리소화물취급소,41,49,90,37.5805903074,127.0511350317
06578,신성미소지움아파트,186,104,290,37.5786581335,127.0495757982
06579,전농1동치안센터,47,81,128,37.5762782623,127.0476065132
06580,동대문해병전우회,73,73,146,37.5763718959,127.0455245142
06581,태양어린이.동아아파트,134,131,265,37.5740642361,127.0454348029
06582,한신휴플러스후문,67,69,136,37.572989629,127.0467315569
06583,신답역,42,83,125,37.5711404728,127.0492345839
06584,장미예식장,10,61,71,37.5701586306,127.0505437481
06585,동부자동차매매시장,6,192,198,37.5689958143,127.0514870981
06586,답십리역.경우회매장입구,2,246,248,37.567473882,127.0534863549
06587,답십리쌍마사거리,1,117,118,37.5661899369,127.0552015711
06588,부속상가,21,41,62,37.5651430993,127.0566146653
06591,고려대역3번출구,749,379,1128,37.5904833874,127.0365261369
06594,의료원입구사거리,6,1265,1271,37.5926993775,127.052658489
06595,삼육서울병원,141,106,247,37.5902762019,127.0622219909
06774,신설동로터리.서울풍물시장,278,487,765,37.5742755859,127.0234166489
06775,경동시장앞,1196,767,1963,37.58056802,127.0386578148
06776,경동시장사거리,1200,770,1970,37.5772293536,127.038109149
06779,동답초교.대림아파트,740,606,1346,37.5712072227,127.0652298839
06780,정화여자중.상업고등학교,85,290,375,37.5868028035,127.0417530049
06781,정화여자중.상업고등학교,87,72,159,37.5866113105,127.0418434744
06999,동대문노인종합복지관,31,41,72,37.5863103228,127.0492581619
07001,망우역,2318,1726,4044,37.5978283589,127.0911385806
07002,망우역,1793,2854,4647,37.5976031898,127.0904651716
07003,상봉역.중랑우체국,2452,2686,5138,37.5959590869,127.0837435605
07004,상봉역.중랑우체국,1522,2215,3737,37.5957231398,127.0833008263
07005,중랑역.동부시장,2096,3080,5176,37.5939710999,127.076052048
07006,중랑역.동부시장,3187,2368,5555,37.5936152929,127.0749381812
07007,망우역.망우지구대,2106,1037,3143,37.5988449322,127.0953897414
07008,망우역.망우지구대,1118,1633,2751,37.5985580019,127.0948710737
07009,우림시장.망우사거리,1199,849,2048,37.5995720624,127.0986406612
07010,우림시장.망우사거리,995,1551,2546,37.5993651842,127.0982214008
07011,금란교회,1184,274,1458,37.6005297976,127.1040333871
07012,금란교회,265,924,1189,37.6003640418,127.1033574704
07013,뫼루니육교,3,3,6,37.6004643043,127.1089021873
07014,동부제일병원.망우리공원,69,252,321,37.600478,127.107756
07015,판교원마을1.2단지.판교도서관,4,2,6,,
07016,한림아파트,2,0,2,,
07017,한림아파트,0,2,2,,
07018,너더리육교,3,0,3,,
07020,너더리육교,1,2,3,,
07021,운중동행정복지센터사거리,17,3,20,,
07043,미금역.2001아울렛,2,36,38,,
07045,미금역.2001아울렛,28,0,28,,
07057,오리역,0,4,4,,
07058,오리역,5,0,5,,
07060,하얀마을.구미도서관,14,0,14,,
07101,극동늘푸른아파트,459,319,778,37.6147026458,127.0764039758
07102,묵동자이.신도브래뉴아파트,306,270,576,37.6152702687,127.0765885798
07103,묵동삼거리.먹골역,369,202,571,37.6125566965,127.0771199228
07104,먹골역.묵동자이아파트,263,373,636,37.6138350067,127.0770859657
07105,한국전력동대문중랑지사,798,714,1512,37.6069574374,127.0782566814
07106,한국전력동대문중랑지사,566,875,1441,37.6062295611,127.0787485573
07107,지하철7호선중화역,1156,1170,2326,37.6026485718,127.0791563016
07108,지하철7호선중화역,1174,985,2159,37.602844147,127.0794497843
07109,국민은행중화동지점,1164,744,1908,37.5988415137,127.079861688
07110,중화동한신아파트,774,1202,1976,37.5990762154,127.0801694529
07111,상봉2동복합청사.도서관,767,718,1485,37.5918910703,127.0799782951
07112,상봉2동복합청사.도서관,607,537,1144,37.5920379201,127.0802876655
07113,면목2동주민센터,441,486,927,37.5893825204,127.079858977
07114,중목초등학교,300,465,765,37.590203,127.080221
07115,면목2동,369,337,706,37.5871549201,127.0797304665
07116,면목2동,364,344,708,37.5874792439,127.0801196457
07117,면목5동주민센터,610,416,1026,37.584884485,127.0796318097
07118,장안시장,382,542,924,37.5855216728,127.0800230935
07119,면목신우아파트,97,109,206,37.5802709857,127.0794405095
07120,면목신우아파트,78,266,344,37.5806329732,127.0798122666
07121,면목119안전센터,913,775,1688,37.5735215001,127.0799088318
07122,경남아너스빌아파트앞,460,370,830,37.5747495207,127.0801546872
07123,늘푸른동아아파트,464,668,1132,37.5724984572,127.0803571864
07124,중랑역동부시장1,365,286,651,37.5939241378,127.0755226426
07125,중랑역.동부시장1,206,170,376,37.5939499392,127.0767665567
07128,한샘교회,133,333,466,37.5954173697,127.0824936944
07129,신내지하차도,818,1085,1903,37.5994734943,127.0971021652
07130,상봉역2번출구,328,225,553,37.5966238431,127.0872459258
07131,신내지하차도,1065,967,2032,37.599481396,127.0973547272
07132,중랑구방정환교육지원센터,248,42,290,37.5973635689,127.0886276147
07133,망우역,80,23,103,37.5986432684,127.0940702529
07134,망우역,175,577,752,37.5986916426,127.0955395871
07135,망우지구대,493,253,746,37.599037,127.095842
07136,양원숲초등학교,21,80,101,37.6096870825,127.1048434288
07137,하나은행망우동지점,220,91,311,37.5996261667,127.0985869435
07138,양원숲초등학교,27,89,116,37.6099687342,127.1047390625
07140,금란교회앞,278,98,376,37.6006015315,127.1037916856
07141,금란교회앞,54,193,247,37.6001700274,127.1026813241
07142,능산사거리,25,21,46,37.6084800438,127.1019452732
07143,망우동고개,933,376,1309,37.6006884215,127.1073787404
07144,서울우유앞,252,559,811,37.592108,127.072817
07145,서울우유앞,580,374,954,37.5914485486,127.0731675854
07146,중랑초등학교,98,305,403,37.58932,127.074318
07147,중랑초등학교,231,84,315,37.5895100706,127.0742727085
07148,동부시장남문입구,280,262,542,37.5904314044,127.0776647513
07149,동부시장남문입구,622,511,1133,37.5907703673,127.078259265
07150,88병원,256,254,510,37.5913119461,127.0808960477
07151,상봉2동주민센터,230,200,430,37.5916499462,127.0810883377
07152,서울창업카페상봉점,120,118,238,37.592028,127.083885
07153,서울창업카페상봉점,214,214,428,37.59224,127.083713
07154,면목6거리,270,409,679,37.5928794643,127.0878523328
07155,면목6거리,146,401,547,37.5929402273,127.0872031229
07156,상봉신협,161,337,498,37.5933652483,127.0899024613
07157,상봉신협,604,471,1075,37.5936531571,127.0905684056
07158,혜원사거리,32,278,310,37.59388,127.092532
07159,혜원사거리,265,204,469,37.5943706333,127.0936742231
07160,혜원여중고입구,133,403,536,37.594427,127.09505
07161,혜원여중고입구,449,94,543,37.5947723198,127.0955543919
07162,봉우재고개,68,408,476,37.595025,127.097837
07163,봉우재고개,225,103,328,37.5951120639,127.0973048687
07164,우림시장,373,472,845,37.595398,127.09954
07165,우림시장,648,263,911,37.5955711191,127.0992893063
07166,상봉역3번출구,2623,1071,3694,37.5943971396,127.0861765659
07167,상봉역4번출구,1089,2217,3306,37.5941972708,127.0859396558
07168,면목초등학교,442,452,894,37.5913436688,127.0869725161
07169,면목초등학교,222,828,1050,37.5913024354,127.0866780454
07170,지하철7호선면목역,933,1103,2036,37.5891321995,127.0872405771
07171,지하철7호선면목역,1809,687,2496,37.5891662321,127.0875225751
07172,면목본동주민센터.면목정보도서관,704,577,1281,37.5869146062,127.0882415953
07173,면목본동주민센터.면목정보도서관,504,564,1068,37.5865148002,127.0880980871
07174,면동초등학교,816,521,1337,37.5842573049,127.0884543619
07175,면동초등학교,566,673,1239,37.5848547979,127.0883599559
07176,면목우체국.녹색병원,1374,543,1917,37.5820548439,127.0887178358
07177,면목우체국.녹색병원,279,796,1075,37.5827338377,127.088457429
07178,지하철7호선사가정역,616,429,1045,37.5798599612,127.0880662837
07179,사가정역2번출구,977,816,1793,37.5812242521,127.0884337896
07180,면목시장,435,545,980,37.5796470274,127.0876506935
07181,면남초등학교,672,379,1051,37.5786342777,127.0863248288
07182,면남초등학교,306,549,855,37.5783,127.085932
07183,방약국앞,710,283,993,37.5757745627,127.0858494168
07184,방약국앞,255,507,762,37.575997,127.08574
07185,중곡초등학교,245,444,689,37.572917,127.084205
07186,중곡초등학교,586,162,748,37.5731508875,127.0841787922
07187,삼용사입구,387,148,535,37.5976831695,127.1001745527
07188,삼용사입구,125,255,380,37.5969440708,127.1004181775
07189,용마공원입구,648,729,1377,37.5939199282,127.0994371442
07190,용마공원입구,888,642,1530,37.594253,127.099292
07191,면일초등학교,851,921,1772,37.5920174515,127.0984014013
07192,우리은행망우동지점,629,788,1417,37.591217,127.097627
07193,서일대학교,172,573,745,37.58951,127.0967
07194,서일대학교,871,244,1115,37.5891941093,127.0968691549
07195,용마문화복지센터,920,854,1774,37.586485,127.09538
07196,용마문화복지센터,185,477,662,37.586712,127.095167
07197,중화중학교.면목고등학교,272,568,840,37.5839979712,127.0940498031
07198,중화중학교.중랑구가족센터,789,319,1108,37.5847547944,127.0941651172
07199,면중초등학교,459,733,1192,37.5812311904,127.0934632177
07200,면중초등학교,504,387,891,37.5822693524,127.0933286447
07201,한양수자인사가정파크,147,259,406,37.5800702505,127.0928893022
07202,묵동공감대아파트,132,432,564,37.6138410826,127.0781223172
07203,면목동금호어울림아파트,308,321,629,37.5792467583,127.0917165625
07204,면목동금호어울림아파트,174,302,476,37.5778374829,127.0907072898
07205,면목동대원칸타빌아파트,220,256,476,37.5777612239,127.0902826707
07206,용마폭포공원,167,402,569,37.5756922268,127.0887419869
07207,용마폭포공원,173,484,657,37.5759266564,127.0885475333
07208,용마산역,691,458,1149,37.5733815658,127.0866708555
07209,용마산역,353,566,919,37.5735061163,127.0863981576
07210,용마산하늘채아파트,218,398,616,37.5710236763,127.086306987
07211,용마산하늘채아파트,232,216,448,37.5712581697,127.0860197064
07212,묵동구길,701,467,1168,37.6155190845,127.0790554743
07213,묵동구길,940,800,1740,37.6158923116,127.0790668957
07214,묵1동주민센터입구.먹골역,1092,440,1532,37.6118632153,127.077951746
07215,묵1동주민센터입구.먹골역,574,740,1314,37.6125895905,127.0777995873
07216,신성은하수아파트,265,161,426,37.588577899,127.0737056648
07217,신성은하수아파트,123,212,335,37.5884540581,127.0734454772
07218,면목2동한신아파트,413,165,578,37.5873343176,127.0740441033
07219,면목2동한신아파트,125,197,322,37.586758,127.074238
07220,겸재교입구.서울시집집마당,70,197,267,37.5856077735,127.0758895994
07221,겸재교입구.서울시집집마당,215,141,356,37.5859071889,127.0761004529
07222,동서그랜드맨션,538,661,1199,37.5861109566,127.0779518031
07223,동서그랜드맨션,697,241,938,37.5864865532,127.0788070081
07224,하나은행면목지점,666,424,1090,37.586816107,127.081111399
07225,하나은행면목지점,673,656,1329,37.5870278887,127.0810408656
07226,면목복개천,188,607,795,37.587913,127.086043
07227,면목복개천,701,182,883,37.5880528782,127.0856702328
07228,면목역2번출구,1866,867,2733,37.5884955539,127.0886340822
07229,면목역2번출구,415,1470,1885,37.5886788778,127.0885501828
07230,농협앞,393,725,1118,37.5891826734,127.0919716473
07231,농협앞,605,870,1475,37.5894466728,127.0919968842
07232,혜원여중고후문,114,775,889,37.590197,127.09618
07233,혜원여중고후문,1126,107,1233,37.590464896,127.0963952514
07234,면목마젤란아파트,58,86,144,37.5868243425,127.0837401254
07235,면목마젤란아파트,51,58,109,37.5867052516,127.0839472075
07236,녹색병원입구,71,48,119,37.5841544497,127.0836907108
07237,녹색병원입구,41,44,85,37.584902585,127.0833643143
07238,면목두산아파트1차,43,42,85,37.5819331246,127.0838863683
07239,면목두산아파트1차,45,59,104,37.5818306838,127.0834865686
07240,면목두산아파트4.5단지,222,131,353,37.5784555953,127.0811929141
07241,면목두산아파트4.5단지,264,140,404,37.5785405427,127.0810260054
07242,사가정센트럴아이파크아파트,521,664,1185,37.5813735031,127.081988552
07243,홈플러스면목동점,981,757,1738,37.581130873,127.0817183593
07244,면목두산아파트2차,462,550,1012,37.5811079401,127.0848478468
07245,면목두산아파트2차,538,1420,1958,37.5809977174,127.0846429611
07246,사가정역,3059,588,3647,37.5809076897,127.0876316521
07247,사가정역3번출구,1070,1667,2737,37.5806624166,127.0872973908
07248,사가정시장,148,1300,1448,37.5806427993,127.0894314037
07249,사가정시장,1605,241,1846,37.5804401745,127.0893009686
07250,용마산교차로,156,306,462,37.5806359279,127.0925022558
07251,중화2동주민센터,518,164,682,37.6016352466,127.0767626166
07252,중화2동주민센터,452,1106,1558,37.6014130353,127.0770110188
07253,중화역3번출구,1947,673,2620,37.6017066002,127.0787352964
07254,중화역3번출구,2702,1317,4019,37.6014504691,127.0789975477
07255,지하철7호선중화역2번출구,251,2048,2299,37.6016944246,127.0806830436
07256,지하철7호선중화역2번출구,701,293,994,37.601522,127.080945
07257,중흥초등학교,261,699,960,37.6017894225,127.082731936
07258,중흥초등학교,301,390,691,37.6016833408,127.0830923091
07259,이화연립경동제일교회앞,317,216,533,37.6023518938,127.084996551
07260,이화연립경동제일교회앞,140,388,528,37.6022944281,127.0853154073
07261,쌍용아파트신내테크노타운앞,649,235,884,37.6032877508,127.0879638335
07262,쌍용아파트신내테크노타운앞,374,823,1197,37.6031155767,127.0880531041
07263,엘지아파트앞,431,209,640,37.6041023768,127.0898625255
07264,엘지아파트앞,213,430,643,37.6039493788,127.0900020003
07265,신현중학교,590,297,887,37.6053101712,127.0917485534
07266,신현중학교,297,977,1274,37.6047917401,127.0914211649
07267,중랑구청,2030,1076,3106,37.6066439712,127.0941822536
07268,중랑구청,930,1998,2928,37.6062056111,127.0936349035
07269,동성프라자앞,990,332,1322,37.6077715316,127.0971854414
07270,동성프라자앞,261,864,1125,37.6077071928,127.0976236907
07271,성원아파트경남아너스빌앞,1370,511,1881,37.6039568351,127.0954657423
07272,성원아파트경남아너스빌앞,651,1514,2165,37.6034500817,127.0958886791
07273,중랑구청사거리,1978,1151,3129,37.6056205222,127.0952115317
07274,중랑구청사거리,686,1303,1989,37.6060573668,127.0953791322
07275,신내동성3차아파트,568,759,1327,37.6076432141,127.0952480857
07276,신내동성1.2차아파트,618,1193,1811,37.6097526098,127.0960572283
07277,신내10단지아파트,787,448,1235,37.6091470123,127.0955629892
07278,신내9단지아파트,891,526,1417,37.6105694794,127.0959906996
07279,신내8단지아파트.서울의료원,1106,673,1779,37.6131148914,127.0961797384
07280,신내9단지아파트.서울의료원,803,890,1693,37.612626142,127.0966220017
07281,신내7단지아파트홈플러스,442,114,556,37.6152532096,127.0938875252
07282,신내7단지아파트홈플러스,139,679,818,37.6155235948,127.0937064155
07283,봉화초등학교,2,2,4,37.6137609119,127.0917243901
07284,봉화초등학교,17,27,44,37.6138773039,127.0915285695
07285,신내6단지아파트.옹기테마공원,18,2,20,37.6138970824,127.0904185112
07286,신내6단지,355,121,476,37.6162098628,127.0917761025
07287,신내6단지아파트.옹기테마공원,1,22,23,37.6139812216,127.0900829285
07288,신내우체국.5단지두산대림아파트,263,124,387,37.6165664023,127.0900173419
07289,신내우체국.5단지두산대림아파트,132,304,436,37.6166348689,127.0897718167
07290,구립도서관체육관,345,134,479,37.6156097571,127.0870833854
07291,구립도서관체육관,123,420,543,37.6157123025,127.0871347189
07292,신내4단지아파트,363,259,622,37.6165927675,127.0860809693
07293,신내4단지아파트,221,192,413,37.6165271272,127.086246288
07294,화랑대역6번출구,572,839,1411,37.6196403121,127.0858732595
07295,화랑대역5번출구,338,131,469,37.6198518169,127.0861849977
07296,봉화산역2번출구,430,2324,2754,37.6167043095,127.0931755465
07297,봉화산역3번출구,3340,539,3879,37.616458735,127.0929080569
07298,중랑경찰서후문,95,219,314,37.619876625,127.1055543519
07299,새우개마을,78,11,89,37.6182441062,127.1033558569
07300,신내능마을,23,129,152,37.6143619055,127.1016592961
07301,신내능마을,117,10,127,37.6145594387,127.1014318828
07302,신내교회.신내데시앙아파트,107,1012,1119,37.6105405898,127.101332875
07303,신내교회.신내데시앙아파트,1620,183,1803,37.6105382531,127.101015256
07304,신내초등학교,1042,281,1323,37.6061555986,127.1007499588
07305,신내새한아파트앞,260,858,1118,37.605838161,127.101048541
07306,능산지하차도,199,699,898,37.6009474144,127.1006376085
07307,능산지하차도,581,238,819,37.6010819221,127.1003489912
07308,상봉터미널,132,707,839,37.5964661524,127.0931425288
07309,상봉터미널,991,305,1296,37.5962266864,127.092859113
07310,망우3동주민센터.혜원여중고후문,236,365,601,37.5921676455,127.0935437056
07311,망우3동주민센터.혜원여중고후문,380,263,643,37.5924652462,127.0932383267
07312,동원시장,181,251,432,37.5904581513,127.0937068936
07313,동원시장,305,211,516,37.5903997916,127.0934407109
07314,면목본동파출소,140,189,329,37.5886709536,127.0941326831
07315,면목본동파출소,298,183,481,37.5871759203,127.0942915914
07316,중화2동체육공원,214,154,368,37.6003605105,127.0738729937
07317,중화빗물펌프장,65,114,179,37.5983343549,127.0720150896
07318,중화2동새마을금고,178,114,292,37.595615,127.072125
07319,중화2동새마을금고,177,208,385,37.5955321436,127.0723480536
07320,중랑교동부시장,106,78,184,37.5938170461,127.0724587364
07321,중랑교동부시장,89,174,263,37.5938844814,127.072696613
07324,아남리치카운티아파트,39,95,134,37.5904056002,127.0853817614
07325,망우동고개,138,514,652,37.6012829905,127.1083597586
07327,망우금호어울림아파트,585,174,759,37.6020220028,127.108053267
07328,망우동금호어울림아파트,147,317,464,37.6023627391,127.1080906424
07329,경남아파트.서울특별시북부병원,384,300,684,37.6038260938,127.1071130742
07330,서울특별시북부병원,312,371,683,37.6040965947,127.1071826257
07331,양원역입구,750,400,1150,37.6055398887,127.1061947194
07332,양원역입구,358,342,700,37.6056398133,127.106301327
07333,양원리,348,347,695,37.6095278447,127.1065901668
07334,양원리,557,338,895,37.6096361832,127.1065048426
07335,동서울교회,10,105,115,37.6117522212,127.1052682161
07336,동서울교회,35,41,76,37.6115852113,127.105257509
07337,중랑공영차고지,24,540,564,37.613645229,127.1020230606
07346,면목아남아파트,57,65,122,37.5903178004,127.0850893069
07347,중랑소방서,39,323,362,37.6148745872,127.0952202984
07348,세방아파트입구,69,28,97,37.6151092487,127.0846193165
07349,원묵고등학교,50,89,139,37.6156010333,127.0855859412
07350,먹골파출소.신안아파트입구,32,56,88,37.6145590063,127.0823392781
07351,먹골파출소.신안아파트입구,89,35,124,37.6144133573,127.0812404699
07352,신안2차아파트,27,164,191,37.6147974229,127.0788949924
07353,신안2차아파트입구,74,38,112,37.6144119098,127.080062537
07354,중랑소방서,78,166,244,37.6146822138,127.0952174211
07355,송곡여고양원역,294,113,407,37.6057286331,127.105800493
07356,송곡여고양원역,24,165,189,37.605473,127.1056
07357,엘림재가방문요양센터,37,14,51,37.6046853285,127.1035239722
07358,엘림재가방문요양센터,12,44,56,37.604392,127.103255
07359,이화미디어고.중랑숲어린이도서관,72,37,109,37.6032313021,127.1021141659
07360,이화미디어고.중랑숲어린이도서관,26,59,85,37.6031193851,127.1023246716
07361,금란교회,152,24,176,37.601292358,127.101992086
07362,금란교회,33,103,136,37.60118,127.10215
07363,망우사거리,97,37,134,37.6005378384,127.1001455367
07364,망우사거리,6,68,74,37.6003751191,127.0999213485
07365,신내지하차도,210,45,255,37.5999201792,127.0974107927
07366,신내지하차도,79,44,123,37.5997615516,127.0974547542
07367,신내6단지아파트,87,204,291,37.6164103875,127.0917055579
07369,이수아파트앞시장입구,93,111,204,37.6182750652,127.0830767893
07370,이수아파트앞시장입구,131,65,196,37.6181760443,127.082952084
07371,묵동교,8,162,170,37.618035,127.079282
07372,묵동교,117,27,144,37.618000502,127.0794582367
07373,동양쇼핑,88,153,241,37.6154401612,127.0783873294
07375,우리은행,110,227,337,37.6157665771,127.076789072
07376,묵동교입구.로프트원오피스텔,198,30,228,37.6155845183,127.076850054
07377,한국아파트,23,29,52,37.6149321561,127.073241805
07378,동구햇살아파트,68,68,136,37.6134823027,127.0740058681
07379,묵동롯데시네마,58,54,112,37.6148475372,127.0752719666
07380,묵동롯데시네마,75,101,176,37.615029837,127.0755071723
07381,브라운캐슬,56,29,85,37.613589603,127.075317679
07382,브라운캐슬,70,66,136,37.6136191751,127.0755737065
07383,먹골역입구,88,62,150,37.6114639864,127.0758008697
07384,먹골역입구,61,101,162,37.6114909487,127.0759056609
07385,묵2동주민센터,97,71,168,37.6098946925,127.0760354677
07386,묵2동주민센터,75,110,185,37.6099095261,127.0761956874
07387,금보당금은방,44,49,93,37.6081884895,127.0764232694
07388,금보당금은방,51,59,110,37.6079263237,127.0766496237
07389,신묵초등학교입구,67,69,136,37.6067354594,127.0767077415
07390,신묵초등학교,65,76,141,37.6067399055,127.0767983469
07391,제일시장,83,72,155,37.6049696369,127.0769920333
07392,제일프라자,89,94,183,37.6049962662,127.0771419617
07393,신동신약국,38,30,68,37.6035367408,127.0772499173
07394,신동신약국,39,67,106,37.6034689076,127.0774178373
07395,중화역입구대원사약국,75,127,202,37.6012530842,127.0777107671
07396,중화역입구대원사입구,99,51,150,37.601900968,127.0777474502
07397,태릉시장입구,51,77,128,37.5994786312,127.0780328218
07398,태릉프라자약국농협,44,47,91,37.5983356921,127.0771464085
07399,태릉시장입구굴다리,56,101,157,37.5966765194,127.0757518958
07401,우남푸르미아아파트,33,79,112,37.6072435159,127.0992085559
07402,우남푸르미아아파트,63,17,80,37.606984993,127.0992197585
07403,신내초등학교,55,36,91,37.6051950212,127.0977024595
07404,신내초등학교,52,52,104,37.6053772766,127.0979376894
07405,경남아파트,61,37,98,37.6028372991,127.0969519586
07406,대명프라자,41,100,141,37.6024633795,127.0970063858
07407,건영아파트,25,53,78,37.6023453076,127.0959547422
07408,상봉1동주민센터,244,398,642,37.6004378473,127.0876490313
07409,상봉1동주민센터,358,172,530,37.6006651301,127.0873672963
07410,청솔마을,125,280,405,37.601538208,127.0874691143
07411,신내쌍용아파트,186,199,385,37.6022345053,127.087174952
07415,면목두산아파트2.3단지,81,106,187,37.579814057,127.0826783287
07417,망우역,124,245,369,37.5986297908,127.0929810127
07418,중랑공영차고지.신내역,817,269,1086,37.613532392,127.102796137
07420,서울특별시북부병원,1,79,80,37.605022,127.108843
07421,양원역,386,208,594,37.6063443498,127.1074180142
07422,성은교회앞,159,119,278,37.5971721716,127.0719816228
07424,해모로아파트앞,15,102,117,37.6019303688,127.1113412232
07425,먹골역5번출구,1261,656,1917,37.6089365533,127.0778546804
07426,먹골역4번출구,639,1082,1721,37.6093643524,127.0781824676
07427,중화2동체육공원,161,119,280,37.6003626826,127.0736950143
07429,태릉고등학교앞,36,122,158,37.618437592,127.0853769562
07430,태릉고등학교.원묵초등학교,61,280,341,37.61829,127.087245
07431,태릉고등학교.원묵초등학교,87,90,177,37.6180387443,127.087341249
07432,서울의료원후문,88,474,562,37.6137726593,127.0974333582
07433,서울의료원후문,402,216,618,37.613665,127.098397
07434,신내데시앙아파트후문,24,244,268,37.6131628134,127.0994457719
07435,신내데시앙아파트후문,387,66,453,37.6130754494,127.1002631605
07436,중화중학교삼거리,402,376,778,37.5864491668,127.0948851433
07438,신내차량사업소입구,324,96,420,37.6126730935,127.10186655
07439,용마산빌라,151,250,401,37.5713121285,127.0841213979
07440,신내역1번출구,82,239,321,37.6124792229,127.1033381633
07442,능말입구,2,121,123,37.6138466599,127.1056704161
07443,망우리역사문화공원,1,36,37,37.6015482363,127.1152135677
07444,망우리역사문화공원,6,22,28,37.6018460877,127.1153104035
07446,신내SKV1센터,295,351,646,37.614461291,127.1132712119
07447,능말입구,9,116,125,37.6137803146,127.1054798008
07448,중랑경찰서후문,129,18,147,37.6196890354,127.1048418581
07450,당너머,74,12,86,37.612606,127.109738
07451,당너머,5,85,90,37.612494,127.109838
07452,신내데시앙포레아파트220동앞,199,390,589,37.6154037584,127.1128015572
07453,신내데시앙포레아파트220동앞,579,57,636,37.6159863803,127.1127524972
07454,신내데시앙포레아파트정문앞,98,1042,1140,37.6165642773,127.1109420061
07455,새솔초등학교입구,1110,38,1148,37.6172677017,127.1098030048
07456,새솔초등학교,17,709,726,37.6174362942,127.1083861254
07457,중랑경찰서정문.우디안101동앞,14,535,549,37.6177710478,127.1056205034
07458,중랑경찰서정문.우디안101동앞,845,9,854,37.6176886487,127.1053545797
07459,신내우디안아파트107동앞,5,445,450,37.6156282044,127.1054535122
07460,신내우디안아파트107동앞,652,10,662,37.6152979971,127.1058994532
07461,신내10단지아파트,79,117,196,37.6103866911,127.0952912241
07462,중랑공영차고지삼거리,506,6,512,37.6129735956,127.1046668259
07463,우디안아파트114동앞,114,23,137,37.6188635865,127.1074162008
07464,우디안아파트114동앞,23,407,430,37.6190845701,127.1071503349
07465,늘푸른근린공원,573,240,813,37.5831084305,127.0796405872
07466,늘푸른근린공원,529,651,1180,37.5830485102,127.0799298741
07467,브라운캐슬B동,44,27,71,37.6136471439,127.0749989291
07476,구미동차고지앞,44,17,61,,
07491,지역난방공사,0,1,1,,
07494,화랑공원남편,3,3,6,,
07495,금토천교,76,1,77,,
07496,삼평교,67,4,71,,
07498,삼평교,2,51,53,,
07499,금토천교,8,20,28,,
07500,화랑공원남편,153,102,255,37.5876130613,127.1019875708
07501,판교유스센터.판교종합사회복지관,29,4,33,37.6000603766,127.082531829
07502,판교유스센터.판교종합사회복지관,480,4,484,37.5882702086,127.1000297097
07503,정신교회,3,0,3,37.599794443,127.0813967466
07504,마을금고,1,0,1,37.5996788543,127.0804464349
07505,공판장,140,9,149,37.5886290229,127.0991229153
07506,수협,1,2,3,37.5995534192,127.0793873937
07507,새마을금고,166,15,181,37.5891664311,127.0976560283
07508,동구햇살아파트,17,0,17,37.5997722467,127.0782426453
07509,서일대정문,180,24,204,37.5883050259,127.0960782719
07510,서울동부새마을금고본점,127,29,156,37.5877930543,127.094431648
07511,서일대정문,24,178,202,37.587813951,127.0961200991
07512,면목역,961,1127,2088,37.588313321,127.0869542692
07515,뫼루니육교,179,178,357,37.5896743021,127.0760239509
07516,화랑공원동편,1,2,3,,
07517,한신아파트상가,245,224,469,37.5884214469,127.0765526169
07518,IBK기업은행면목동지점,44,158,202,37.5876550553,127.085009712
07519,한신아파트후문,194,102,296,37.5873563919,127.0765028357
07520,마을금고,0,4,4,37.5995049778,127.0803975494
07521,정신교회,0,5,5,37.5996555334,127.0816027142
07523,중화동종점,0,11,11,37.599933245,127.0826438086
07524,지하철7호선면목역,1434,814,2248,37.588387996,127.088323368
07525,면목지구대,33,238,271,37.5878158428,127.0941044299
07526,새마을금고,44,237,281,37.5890945823,127.097321946
07527,공판장,1,283,284,37.5884903229,127.0990423344
07528,진주빌라.바다약국,4,399,403,37.588189,127.099993
07529,진로아파트앞.종점,4,94,98,37.5875477419,127.1019846511
07530,수협,0,2,2,37.5993830841,127.0794313809
07550,중랑공영차고지.신내역,391,463,854,37.613209,127.103628
07551,중랑공영차고지.종점,0,378,378,37.613322,127.104468
07552,화랑공원동편,2,3,5,,
07553,성남시운중도서관,1,6,7,,
07554,성남시운중도서관,183,1112,1295,37.5807358238,127.0870023398
07587,판교포레라움아파트,0,3,3,,
07588,판교포레라움아파트,0,2,2,,
07592,태영데시앙,14,1,15,,
07593,경남아너스빌.서판교성당,2,1,3,,
07594,경남아너스빌.서판교성당,1,7,8,,
07595,태영데시앙,1,12,13,,
07616,이매촌한신.서현역.AK프라자,293,841,1134,,
07674,이우중고,0,1,1,,
07675,이우중고,0,1,1,,
07817,판교퍼스트힐푸르지오1단지,4,5,9,,
07818,판교퍼스트힐푸르지오1단지,5,1,6,,
07819,판교퍼스트힐푸르지오2단지.판교SK뷰테라스,0,12,12,,
07820,힐스테이트판교엘포레6단지.판교SK뷰테라스,6,0,6,,
07821,힐스테이트판교엘포레6단지,3,2,5,,
07822,금강테라스하우스,5,6,11,,
07827,판교대장로서측,5,2,7,,
07828,판교대장로동측,0,2,2,,
07829,판교풍경채5단지,11,13,24,,
07830,힐스테이트판교엘포레4단지,9,5,14,,
07831,판교반디유치원.복합문화단지,12,21,33,,
07832,더샵판교포레스트11단지,12,5,17,,
08001,길음2동주민센터,2452,2108,4560,37.6069061871,127.028209324
08002,길음2동주민센터,1647,2583,4230,37.6061107314,127.027468805
08003,길음뉴타운,4857,3941,8798,37.6037080396,127.0242800346
08004,길음뉴타운,2827,3578,6405,37.603111303,127.0234418237
08005,미아리고개.미아리예술극장,4044,3496,7540,37.5988112954,127.0217090638
08006,미아리고개.미아리예술극장,2846,3617,6463,37.5979210002,127.0218209221
08007,돈암사거리.성신여대입구,3413,4965,8378,37.5937432794,127.0181313708
08008,돈암사거리.성신여대입구,7104,5411,12515,37.5932509586,127.0176837862
08009,삼선교.한성대학교,5212,4652,9864,37.5899227463,127.0093609216
08010,삼선교.한성대학교.조소앙활동터,5882,6197,12079,37.589325923,127.0082314311
08101,숭곡초교입구,817,988,1805,37.6098576825,127.0320881862
08102,창문여고,2558,2268,4826,37.6118505947,127.035819966
08103,동방고개,96,93,189,37.6137075663,127.0382739231
08104,장위동그린빌아파트,38,170,208,37.6178525754,127.0431131466
08105,북서울꿈의숲,443,598,1041,37.6203171059,127.0453451219
08106,장월초등학교,573,670,1243,37.6235604931,127.0486034702
08107,국민대앞,2059,1166,3225,37.6106795513,126.9940273315
08108,국민대앞,16,907,923,37.611089494,126.9940766263
08110,국민대학교앞,1087,1221,2308,37.6108079623,126.9946485975
08111,청덕초등학교,1117,415,1532,37.6086704828,126.999082643
08112,청덕초교,678,1616,2294,37.60863,127.00006
08113,북악중학교,1293,211,1504,37.607386,127.002908
08114,고려대사범대학부속고등학교,299,1385,1684,37.607888,127.002378
08115,봉국사,157,224,381,37.605854,127.007624
08116,봉국사,238,420,658,37.606138,127.007657
08117,정릉2동주민센터,815,715,1530,37.604593,127.011258
08118,정릉2동주민센터,970,871,1841,37.6049808949,127.0111989608
08119,숭덕초교,2396,1955,4351,37.6033583637,127.0146827395
08120,숭덕초교,2382,2045,4427,37.603698019,127.0151143204
08121,정릉길음시장,2672,1579,4251,37.6022155634,127.0193251172
08122,정릉길음시장.길음뉴타운9단지,206,602,808,37.6025691568,127.0195998271
08123,길음역2번출구.돈암삼성아파트,2055,2658,4713,37.6018744304,127.0245753189
08124,길음역3번출구B,2850,995,3845,37.6020413112,127.0237698953
08125,돈암1동주민센터,297,193,490,37.6036715396,127.0264232103
08126,돈암1동주민센터,305,847,1152,37.6045116804,127.0265678982
08127,종암사거리,83,490,573,37.603607,127.031172
08128,KT월곡지사,264,230,494,37.6024463961,127.0343782041
08129,KT월곡지사,747,661,1408,37.6030292596,127.0347002149
08130,종암SK아파트,272,255,527,37.602046721,127.0376139648
08131,성북구보건소,1096,559,1655,37.6025890639,127.0391628595
08132,월곡역,426,1328,1754,37.601628727,127.0414527013
08133,월곡역,1655,711,2366,37.6030699938,127.0423481401
08134,동덕여대앞,385,401,786,37.6030027838,127.0428338902
08135,상월곡역.한국과학기술연구원,215,423,638,37.605588258,127.0472775982
08136,상월곡역.한국과학기술연구원,583,285,868,37.605489,127.046447
08137,월곡중학교,228,372,600,37.606895,127.049787
08138,월곡중학교,399,278,677,37.6069663554,127.0492360318
08139,새석관시장,394,540,934,37.608343,127.052529
08140,새석관시장,612,360,972,37.6084472513,127.0521051555
08141,돌곶이역5번출구,274,324,598,37.6114513128,127.058486517
08142,돌곶이역1번출구,869,959,1828,37.6105861206,127.0562084808
08143,장위동동원베네스트.온누리병원,317,339,656,37.612043,127.058969
08144,석관동주민센터,86,222,308,37.6133957,127.0619141881
08145,석관동주민센터,232,198,430,37.6134412485,127.0614333997
08146,석계역굴다리앞,380,562,942,37.6143314819,127.0657965807
08147,석계역4번출구,1541,290,1831,37.6151057128,127.0671118539
08148,성가복지병원,1504,1540,3044,37.6058827177,127.0311378827
08149,성가복지병원,1431,1866,3297,37.6059227612,127.0315287406
08150,종암사거리입구,3153,3446,6599,37.6014326326,127.0330443723
08151,종암사거리입구,2882,2305,5187,37.6011063729,127.0336839773
08152,종암동주민센터,3553,2231,5784,37.5994152643,127.0341075456
08153,종암동주민센터,2537,3523,6060,37.5983737481,127.0349566767
08154,숭례초교,3250,2161,5411,37.5948052663,127.0356811781
08155,숭례초등학교,2752,3572,6324,37.5943969245,127.036170198
08156,고대앞,1691,2271,3962,37.5885636851,127.0348108154
08157,우신향병원,799,764,1563,37.5851359404,127.0316104668
08158,안암오거리,960,571,1531,37.5824863475,127.029064935
08159,대광초교,682,510,1192,37.5797066498,127.0250277117
08160,정릉북한산국립공원입구,589,5,594,37.6177209169,126.9992949087
08161,정릉산장아파트,1896,50,1946,37.6167130001,127.0033451915
08162,정릉대우아파트,29,1653,1682,37.616708,127.00386
08163,정릉4동주민센터.경국사,654,330,984,37.6135243952,127.0063369706
08164,정릉4동주민센터.경국사,102,740,842,37.6133621964,127.0067135499
08165,성북청수도서관.정릉4동성당,1183,291,1474,37.6115696748,127.0084193769
08166,성북청수도서관.정릉4동성당,307,907,1214,37.6108955811,127.0090747434
08167,정릉시장입구,2134,710,2844,37.6084653256,127.0098212542
08168,정릉시장입구,1220,1751,2971,37.6080327763,127.0101519307
08169,정릉우체국앞,1931,684,2615,37.6051645031,127.0114121305
08170,정릉우체국앞,820,1817,2637,37.6053925733,127.0115259154
08171,미아초교,1414,541,1955,37.6115318739,127.0220389791
08172,미아초교,452,1307,1759,37.6108866161,127.0224658136
08173,길음동동부아파트,696,542,1238,37.607282869,127.023530903
08174,길음동동부아파트,303,1169,1472,37.6080248717,127.0234547019
08175,삼선동주민센터,2259,2656,4915,37.5906107149,127.0143473137
08176,삼선동주민센터,2542,2306,4848,37.5906917676,127.0147153546
08177,성북구청.성북경찰서,2383,1815,4198,37.5881513802,127.0174306588
08178,성북구청.성북경찰서,2572,3009,5581,37.5886054063,127.0172299027
08179,보문역2번출구,1209,1527,2736,37.5858514183,127.0189209428
08180,보문역6번출구,818,772,1590,37.5848759024,127.019770675
08181,보문동성당,941,700,1641,37.5823963244,127.0207962235
08182,보문동성당,529,737,1266,37.582398971,127.0211155216
08183,보문동주민센터,909,863,1772,37.5804514958,127.0218634882
08184,보문동주민센터,784,880,1664,37.5800480873,127.0223781466
08185,월계2교.참누리아파트,620,471,1091,37.6232183587,127.0503746013
08186,월계2교,308,458,766,37.623825,127.050133
08187,광운초교앞,665,337,1002,37.6199529582,127.0529580116
08188,광운초교,391,449,840,37.6202857913,127.053113038
08189,성북청소년센터,385,164,549,37.616488,127.056887
08190,성북청소년센터,92,308,400,37.6161560006,127.0575142283
08191,장위자이레디언트아파트,124,174,298,37.6141178016,127.0592242299
08192,장위자이레디언트아파트,248,218,466,37.61397337,127.0597361132
08193,장위사거리,221,138,359,37.6115892599,127.0618334097
08194,장위사거리,111,199,310,37.6119253322,127.0618298638
08195,의정부초등학교,343,326,669,37.6092611472,127.0640251528
08196,석관고등학교,219,270,489,37.6094354736,127.064361798
08197,석관동코오롱아파트,522,169,691,37.6065852831,127.0661262457
08198,석관동코오롱아파트,216,516,732,37.606698968,127.0663652319
08199,북서울꿈의숲,424,109,533,37.6192462321,127.0451012788
08200,북서울꿈의숲,63,297,360,37.6191131219,127.0456590521
08201,장곡초교앞,780,52,832,37.6176594647,127.0477168014
08202,장곡초교앞,185,543,728,37.6177065388,127.0479421691
08203,하나은행장위동지점,777,92,869,37.6162107764,127.0500209793
08204,하나은행장위동지점,83,845,928,37.61643,127.050048
08205,장위동원천주유소,492,503,995,37.6146908982,127.0525710587
08206,장위동원천주유소,93,670,763,37.6146307869,127.0529741295
08207,돌곶이역2번출구,156,1199,1355,37.6120921548,127.0555322537
08209,돌곶이역7번출구,1436,649,2085,37.6102045872,127.0575578503
08210,돌곶이역3번출구,2079,498,2577,37.611744,127.056203
08211,석관시장,471,502,973,37.6086897394,127.0590704145
08212,석관시장,688,703,1391,37.6090023944,127.0590600371
08213,석관동새마을금고,333,583,916,37.6074589679,127.0603973513
08214,석관동새마을금고,427,487,914,37.6072717639,127.0609375732
08215,한국예술종합학교,604,527,1131,37.6056471604,127.0618293174
08216,한국예술종합학교,717,505,1222,37.6057619079,127.0620208629
08218,돈암힐스테이트.코오롱하늘채,139,18,157,37.5984370068,127.0142965055
08219,꿈의숲아이파크아파트,211,688,899,37.6180160676,127.0513840846
08220,꿈의숲아이파크아파트,721,190,911,37.6180139626,127.0510442788
08221,장곡초교사거리,251,759,1010,37.617145,127.050007
08222,장곡초교사거리,605,222,827,37.617273387,127.0499054393
08223,서울다원학교.한용운활동터,328,98,426,37.594504378,126.9918132916
08224,동방문화대학원대학교,176,5,181,37.5944954542,126.9931664205
08225,동방문화대학원대학교,19,208,227,37.5947840057,126.9937265473
08226,성북구립미술관.쌍다리앞,596,10,606,37.5935941166,126.9958337905
08227,성북구립미술관.쌍다리앞,15,362,377,37.5937446022,126.995943628
08228,성북초교.성북선잠박물관,281,19,300,37.5930630687,126.9987771128
08229,성북초교.성북선잠박물관,21,376,397,37.5930854464,126.9978031597
08230,홍익대부속중고등학교입구,1077,65,1142,37.5932175334,127.0006477466
08231,홍익대부속중고등학교입구,96,684,780,37.5932724917,127.0015310386
08232,경신중고입구,451,49,500,37.5917865725,127.0028344034
08233,경신중고입구,34,609,643,37.5924098258,127.0026665502
08234,성북동주민센터.서울동구고,545,335,880,37.5907466938,127.0036474176
08235,성북동주민센터.서울동구고,116,523,639,37.5909389227,127.0038751968
08236,삼선교.성북문화원,139,207,346,37.588812,127.005502
08237,삼선교.성북문화원,3038,900,3938,37.589094071,127.0056130939
08238,서울다원학교.한용운활동터,39,217,256,37.5947386247,126.9916547399
08239,장위래미안아파트,794,418,1212,37.618894052,127.0524720755
08240,신종월교,5,13,18,37.5973107996,127.0412493106
08242,장위래미안아파트,395,266,661,37.6188534243,127.0526589415
08243,남대문중학교,406,156,562,37.6180556213,127.0546974877
08244,남대문중학교,203,241,444,37.617766679,127.055378769
08245,길음시장,460,1776,2236,37.603009102,127.023582426
08246,길음시장,790,380,1170,37.603149768,127.0230920656
08247,길음역10번출구,512,884,1396,37.6046830059,127.0259507581
08248,길음역9번출구,284,234,518,37.605087769,127.0259217322
08249,미아사거리,212,153,365,37.6101676658,127.0300443665
08250,서경로꿈마루도서관앞,514,31,545,37.6115052388,127.013387398
08251,길원초등학교입구,700,22,722,37.6104382371,127.0143749082
08252,길원초등학교입구,47,1174,1221,37.610337,127.014672
08253,길음뉴타운11단지롯데캐슬,588,34,622,37.608833917,127.0153629325
08254,길음뉴타운11단지롯데캐슬,52,853,905,37.608783,127.015477
08255,정릉동아.길음뉴타운데시앙아파트,805,118,923,37.606292268,127.0149528803
08256,길음뉴타운데시앙.정릉동아아파트,56,967,1023,37.60641,127.015123
08257,숭덕초교,197,477,674,37.6038076998,127.0145783295
08258,성북생태체험관,88,2,90,37.6202232341,127.0064961192
08259,정릉초교,614,2,616,37.619058,127.00634
08260,정릉동풍림상가앞,741,10,751,37.6167005028,127.0077085694
08261,정릉동풍림상가앞,101,710,811,37.6167639907,127.008189261
08262,정릉동풍림아파트.청소년문화의집,622,415,1037,37.6164772363,127.0086761598
08263,정릉입구.정릉역,750,428,1178,37.6024257513,127.0135090711
08264,정릉입구.정릉역,683,657,1340,37.6028763481,127.0135073176
08265,아리랑고개.아리랑시네미디어센터,1869,724,2593,37.6006317832,127.0137784395
08266,아리랑고개.아리랑시네미디어센터,613,1676,2289,37.6004661719,127.0137361959
08267,돈암2동주민센터입구.흥천사,984,1007,1991,37.5967201329,127.0151169845
08268,송현고등학교,605,1006,1611,37.596199747,127.01560379
08269,세아.보광.건영아파트앞,879,3509,4388,37.5937399685,127.0161354636
08270,송현고등학교.장애인종합복지관,5397,1337,6734,37.5937466869,127.0164185434
08271,한국과학기술연구원입구,5,1,6,37.603913,127.044818
08272,대농빌라앞,11,0,11,37.601778,127.043291
08273,월곡샹그레빌아파트,38,2,40,37.5954776166,127.0408149328
08274,월곡샹그레빌아파트,38,25,63,37.5954008225,127.0408915697
08275,장위동고개,231,1387,1618,37.6142454988,127.0406505559
08276,장위동고개,821,269,1090,37.6143780182,127.0409175754
08277,장위1동주민센터,303,782,1085,37.613861789,127.0427868796
08278,장위1동주민센터,1079,566,1645,37.6139940851,127.043464302
08279,장위1동치안센터,97,436,533,37.613833,127.045172
08280,장위1동치안센터,684,410,1094,37.6139750583,127.046117453
08281,청소년문화누림센터,200,699,899,37.6135912081,127.0484390748
08282,청소년문화누림센터,510,187,697,37.6138828968,127.0487688779
08283,월곡1동주민센터,832,928,1760,37.610829856,127.035225829
08284,월곡1동주민센터,555,449,1004,37.6103304009,127.0356202126
08285,밤나무골시장,396,619,1015,37.6094533376,127.0356802463
08286,월곡삼성래미안아파트,389,537,926,37.609399,127.035937
08287,월곡동두산아파트,695,892,1587,37.6066191426,127.03659179
08288,월곡동두산아파트,977,739,1716,37.60679973,127.0367046867
08289,생명의전화,318,396,714,37.604518,127.037215
08290,생명의전화,583,550,1133,37.6041772379,127.0375355438
08293,장곡초교,684,135,819,37.6162024332,127.0485302331
08294,장곡초교,174,699,873,37.6161195728,127.048798454
08295,보문역5번출구,711,625,1336,37.5854637287,127.0202535696
08296,보문역4번출구,833,583,1416,37.5856511849,127.0200803771
08297,안암동주민센터,467,273,740,37.5860464325,127.021938613
08298,안암동주민센터,345,516,861,37.5862680197,127.0223689592
08299,의정부장애인종합복지관,1107,1104,2211,37.58617438,127.0259867888
08300,고려대이공대.고대병원,864,1273,2137,37.5864334391,127.0258793196
08301,안암역3번출구,1938,1158,3096,37.586229248,127.0305239036
08302,안암역2번출구,614,1218,1832,37.5863644753,127.0302759807
08303,안암오거리,444,678,1122,37.5832964381,127.0295931093
08304,개운사입구,562,471,1033,37.5858303361,127.029458235
08305,돈암시장입구,1344,701,2045,37.591444,127.016715
08306,돈암시장입구,517,227,744,37.5917149004,127.0167719353
08307,성북구청,9,38,47,37.589376,127.01817
08308,성북구청,8,172,180,37.5899335613,127.0175710536
08309,보문2교,4,22,26,37.5891196342,127.0194349551
08310,보문2교,8,87,95,37.589049348,127.0191459598
08311,성신여대후문,299,247,546,37.5890493392,127.0220957059
08312,성신여대후문,195,233,428,37.5891349314,127.0221070536
08313,용문중고교,103,150,253,37.5876943273,127.0229774528
08314,용문중고교,56,84,140,37.5873563855,127.0231483316
08315,안암초교,26,93,119,37.5869202094,127.0233961765
08316,안암초교,107,117,224,37.5871051895,127.0234339727
08318,돈암초교입구,253,562,815,37.5910757635,127.0121379652
08320,정릉3동주민센터앞,380,96,476,37.608447409,127.0044112283
08321,정릉3동주민센터앞,258,322,580,37.6085559975,127.0047217755
08322,삼덕단지.성북구립최만린미술관,398,228,626,37.6103867411,127.0050597014
08323,삼덕단지.성북구립최만린미술관,186,269,455,37.610417,127.005238
08324,솔샘사거리,202,204,406,37.6127787922,127.0069541753
08325,솔샘사거리,240,232,472,37.6126699762,127.0072777201
08326,보문역3번출구,878,455,1333,37.585933,127.019202
08327,성북우체국현대백화점,1039,816,1855,37.6078214049,127.0293808251
08328,정릉동풍림아파트,234,75,309,37.6164839779,127.008888534
08329,현대백화점,622,543,1165,37.6082685042,127.0292316503
08330,돈암동일신건영휴먼빌아파트,4,44,48,37.601461,127.013386
08332,석계역5번출구,64,51,115,37.6138925287,127.0653703051
08333,석계역,12,223,235,37.6135987601,127.0654622702
08334,월곡2SH빌아파트,17,1,18,37.5975109278,127.0422175977
08335,석관고등학교후문,51,1,52,37.610699249,127.0664988617
08336,길음역3번출구A,2365,395,2760,37.6022078826,127.0243191825
08338,청소년문화의집.정릉e편한세상,237,772,1009,37.6151911012,127.0089068708
08341,상진운수종점,0,41,41,37.6111977438,127.0652478073
08342,상진운수종점,42,64,106,37.6112674279,127.065628767
08344,대진여객차고지,1,570,571,37.617689,127.000797
08347,정릉북한산국립공원입구,0,654,654,37.6178583179,126.9993487096
08348,풍림아파트삼거리,7,440,447,37.617339,127.007432
08349,성북생태체험관,1,204,205,37.6201534076,127.0064961131
08350,정릉초교,1,864,865,37.618938,127.006424
08351,파크빌라앞,28,90,118,37.5982256085,127.005908199
08352,골드하우스,6,167,173,37.5984869558,127.0045550193
08353,월곡중학교,158,36,194,37.6062348572,127.0478487259
08354,민락엘레트19단지후문,32,0,32,,
08355,508단지삼거리,5,441,446,37.5993330895,127.0055357424
08357,산장빌라,3,205,208,37.5990157438,127.0074088371
08358,산장빌라,640,8,648,37.5987761153,127.0073998099
08359,성북참노인전문병원,0,16,16,37.597501,127.005612
08360,교수단지,21,471,492,37.5996669769,127.009282874
08361,우방아파트,190,11,201,37.6002114009,127.0094554943
08363,일신건영아파트.꿈에그린아파트,24,147,171,37.6014914182,127.0121089813
08364,일신건영아파트.꿈에그린아파트,15,8,23,37.6014510424,127.0122269985
08365,돈암힐스테이트.코오롱하늘채,54,105,159,37.5988330463,127.014404006
08366,돈암동일신건영휴먼빌아파트,137,116,253,37.6016437467,127.0136260986
08367,구민회관입구,225,13,238,37.596703351,127.0064556975
08368,508단지입구,95,12,107,37.5991744552,127.006386249
08369,스카이힐스,4,203,207,37.599483255,127.0036633229
08370,508단지삼거리,40,1,41,37.5992258555,127.0056342632
08371,대일외고서경대정문,6,155,161,37.612945,127.013145
08372,서경대본관,1034,226,1260,37.61546,127.011423
08373,서경대본관,378,1171,1549,37.615626,127.011687
08380,길음뉴타운8단지,50,787,837,37.60757,127.015877
08381,길음뉴타운8단지,696,27,723,37.6074068143,127.0157040433
08382,서경로꿈마루도서관앞,34,594,628,37.611633,127.013476
08390,국민커뮤니티센터,10,41,51,37.6122826515,127.0044096525
08391,정릉연립,26,17,43,37.6122135456,127.00437181
08392,국민대후문,3,190,193,37.6111973107,126.9994533062
08393,국민대후문,135,13,148,37.6111729841,126.9998640907
08394,고려대사범대학부속고등학교후문,1,68,69,37.6095059773,126.9992950559
08395,고려대사범대학부속고등학교후문,85,7,92,37.6094614333,126.9995106864
08396,송산초교.상가단지,113,98,211,37.5996556599,127.0411600129
08397,송산초교.상가단지,132,92,224,,
08400,길음뉴타운10단지.라온유아파트,876,1770,2646,37.6029875372,127.0181336142
08401,숭곡초교후문,120,122,242,37.609277551,127.0328337687
08402,월곡아남아파트,231,293,524,37.6064773977,127.0345110882
08403,월곡동신아파트,276,297,573,37.6045305985,127.0360244691
08404,돌곶이역8번출구,522,576,1098,37.610303,127.056327
08405,한성대입구역,195,590,785,37.5893629858,127.0047236816
08406,장위동입구,273,278,551,37.6137313245,127.0390305016
08408,북한산보국문역2번출구,1123,1052,2175,37.612293899,127.0079858233
08409,북한산보국문역1번출구,1841,755,2596,37.6120835499,127.008329146
08410,일신초교.래미안라센트아파트,108,87,195,37.598241968,127.039436762
08411,서울사대부설중학교,44,29,73,37.5961434071,127.0383641124
08412,서울사대부설고등학교,22,40,62,37.5936473735,127.0371653045
08448,일신휴먼빌.우정아파트,184,25,209,37.600439405,127.0112533717
08449,고려아파트,56,101,157,37.5985623481,127.0272458091
08450,장월초교.참누리아파트,99,4,103,37.6234017046,127.0482620157
08451,동방주택,191,215,406,37.6165854246,127.0437263808
08452,장위중학교,255,318,573,37.6119090424,127.0405010899
08453,신안APT.길음초등학교,362,587,949,37.6142243316,127.0164202375
08454,정릉4동종점,180,237,417,37.6129436918,127.0101775182
08455,산림초소,8,14,22,37.6139199881,126.9979440805
08456,정릉2동주민센터,63,20,83,37.6046085645,127.0110779295
08457,성신여대입구역3번출구,1215,762,1977,37.5922918719,127.0164516544
08458,삼선푸르지오APT앞,431,480,911,37.5851583375,127.0135777075
08459,한성대정문,964,1005,1969,37.5825625217,127.0112286496
08460,한신113동앞,169,8,177,37.5943426813,127.0085997586
08462,낙산삼거리,80,2,82,37.5802666048,127.0105670837
08463,돈암2동주민센터,504,41,545,37.5975911861,127.0108661056
08464,종암중학교,57,9,66,37.5932844701,127.0348752977
08465,종암교통정보센터,189,8,197,37.5940261807,127.0359029589
08466,고려슈퍼,93,2,95,37.598640621,127.027767923
08467,슈퍼앞,114,8,122,37.6158087153,127.0422165656
08468,월곡청소년센터,49,6,55,37.6110151894,127.0404315108
08469,대우APT211동,1301,12,1313,37.612893,127.017015
08470,KEB하나은행.오렌지마트,23,1,24,37.6113037986,127.0091703259
08471,중앙하이츠정문,42,16,58,37.6026973686,127.0109779802
08475,구민회관201동앞,131,5,136,37.5955879331,127.0092873052
08477,돈암지구대.현대아파트,246,34,280,37.596978894,127.0127098361
08478,선경아파트,62,11,73,37.5943749086,127.0344613329
08479,세븐마트,81,5,86,37.5925498469,127.0356653798
08480,죽림정사,27,4,31,37.5995314443,127.0292269396
08482,나약국,172,17,189,37.6143344683,127.041354229
08483,동아아파트,65,4,69,37.6081543482,127.0474093545
08484,월곡인조잔디구장,89,12,101,37.6086618783,127.0394708753
08485,대우APT정문.대림APT후문,871,23,894,37.6119651381,127.0176158808
08487,넓은마당,2,0,2,37.6146057316,126.9997043527
08488,중앙하이츠후문,0,13,13,37.6035344728,127.0093597957
08489,성신여대정문앞,240,56,296,37.590765825,127.0197375056
08490,한성대입구3거리,147,88,235,37.5864120039,127.0109450153
08491,법화사,28,2,30,37.5847416354,127.0110898368
08492,이수아파트.한신휴아파트입구,46,172,218,37.5966164967,127.0141174417
08493,극동아파트정문,20,28,48,37.5954238021,127.0343689551
08494,고려대법과대학.한국어교육관입구,45,33,78,37.5913557733,127.0330195331
08495,래미안세레니티,72,64,136,37.5990484356,127.0293309418
08497,장위1동주민센터,264,12,276,37.6138183526,127.0432920552
08498,이지마트,27,17,44,37.6097861067,127.0476777016
08499,월곡1동밤골경로당,2,2,4,37.6074171689,127.0403853901
08500,새생명교회,659,92,751,37.6110319213,127.018240126
08502,도광사,3,0,3,37.6154094907,127.001466925
08503,정수초교,0,22,22,37.6043724341,127.0088361313
08504,성신여대평생교육원,104,166,270,37.5892753684,127.02006663
08505,성신여대입구역,80,1412,1492,37.5935074738,127.0162095823
08506,극동아파트후문,30,38,68,37.5960223777,127.0334881714
08507,고려대안암학사,26,67,93,37.5912582105,127.030584842
08508,통일교회,95,30,125,37.5977570629,127.0297868295
08510,장위1동치안센터,90,16,106,37.6138039967,127.0455235372
08511,GS25장위제일점,20,55,75,37.610855472,127.0482277397
08512,초림빌라,30,14,44,37.6074650247,127.0410680515
08513,대림상가앞,236,14,250,37.6108023697,127.019928561
08514,현대아파트앞,805,176,981,37.6090831925,127.0203178716
08516,산장아파트,15,2,17,37.616659953,127.0035140799
08517,그린빌라,0,16,16,37.6039281291,127.008202672
08519,삼선시장앞,49,78,127,37.5881107312,127.0088742018
08521,종암아이파크2차정문,11,24,35,37.5968921594,127.0326607185
08522,고려대아이스링크,30,92,122,37.5930412509,127.0278066095
08523,그린마트,1,2,3,37.5979829182,127.0310202081
08526,장위천주교앞,17,57,74,37.6126113808,127.0489730694
08527,동덕여대후문,6,11,17,37.6066542137,127.0408382727
08528,대림APT정문,74,31,105,37.6111129362,127.0216763929
08529,래미안821동앞,146,242,388,37.6063912219,127.0217978896
08532,정수빌라,32,35,67,37.6034392147,127.0078193261
08534,한성대입구역.성북천분수마루,168,839,1007,37.5880973543,127.0067691679
08535,부용마을아파트정문,128,215,343,37.5881449546,127.0091097341
08536,동방고개,108,158,266,37.6137524896,127.0383227067
08537,정덕초교입구.이수아파트,71,205,276,37.5967304932,127.0144253969
08538,부용마을아파트정문,58,90,148,37.59774179,127.0330031027
08539,성북구의회,24,26,50,37.594558093,127.0264561677
08540,종암아이파크2차후문,31,35,66,37.5978024471,127.0319702953
08542,장위시장,175,83,258,37.6133087107,127.0500348524
08543,두산아파트후문,89,54,143,37.605962848,127.0402905965
08544,파리바게뜨앞,50,22,72,37.6113884844,127.0226562581
08545,길음시장입구,125,414,539,37.6051725267,127.0223666084
08546,길음역출구,612,289,901,37.6022105821,127.0243523151
08548,그린빌라,5,0,5,37.6037248291,127.0082621961
08550,만가대사거리,485,208,693,37.592651899,127.0088903855
08551,장위동그린빌아파트,41,269,310,37.6177787253,127.0430066211
08552,돈암지구대.현대아파트,35,463,498,37.5971725293,127.0127463341
08554,개운중학교,41,53,94,37.5941781735,127.0248944002
08555,성북노인정입구,5,13,18,37.5978526869,127.0327766528
08557,어해랑앞,24,79,103,37.6139775278,127.0529124982
08558,자산약국.월곡전철역입구.6호선,166,237,403,37.6043412492,127.0392307477
08559,동부아파트.샘물교회앞,139,9,148,37.6118369827,127.0238853806
08560,길음전철역,1771,2266,4037,37.604146,127.024173
08562,수녀원,6,5,11,37.6119203778,127.0053135319
08563,정수초교,3,0,3,37.6041816433,127.0087719123
08564,고려대이공대,69,291,360,37.586127814,127.025042317
08565,만가대사거리,70,20,90,,
08566,삼선교.한성대입구역,42,1423,1465,37.5894788054,127.0051556693
08567,한신103동앞,105,100,205,37.5922035215,127.0082620546
08568,북서울꿈의숲,429,523,952,37.6199450324,127.0451511821
08569,돈암신일해피트리아파트,20,507,527,37.5977882419,127.0110067037
08570,통일교회,64,106,170,37.5978597954,127.0297528957
08571,풍림아파트.성신초교,132,90,222,37.5951930807,127.0235199391
08572,한미약국,499,212,711,37.5989427725,127.0343461633
08574,세광빌라,28,20,48,37.6146086251,127.0541544376
08576,래미안길음센터피스120동앞,5,18,23,37.6120078422,127.0255414558
08580,중앙하이츠후문,6,1,7,37.6034488866,127.0092606947
08581,고대병원,129,383,512,37.5861138287,127.0271631411
08584,풍림106동,27,101,128,37.5976127854,127.0220507277
08585,성북노인정입구,14,11,25,37.5979671042,127.0328514477
08586,장위3동주민센터,139,35,174,37.616426,127.056928
08587,관문약국,93,47,140,37.6156127998,127.0553083192
08588,동덕여대부속유치원앞,27,121,148,37.6061228727,127.0452758609
08589,영훈중고후문.길음래미안센터피스,127,227,354,37.612454342,127.0274932778
08590,성북미디어문화마루,163,24,187,37.604206,127.022848
08592,구.정릉3동주민센터,46,6,52,37.6094883196,127.0058966843
08593,중앙하이츠정문,3,30,33,37.6026956338,127.0107185841
08596,한성대입구역5번출구,477,1235,1712,37.5892202337,127.0050894402
08597,참누리아파트,84,245,329,37.622979,127.047741
08598,BRT.반도유보라아이비파크후문,95,153,248,37.5987114012,127.0203281149
08599,종암아이파크2차후문,71,49,120,37.5979024838,127.0319114484
08600,장위119안전센터,16,26,42,37.6152176785,127.0581116015
08602,우리랜드사우나,37,86,123,37.6167062363,127.0563241001
08603,석계역7번출구,26,130,156,37.614303,127.065428
08604,석관두산아파트,22,14,36,37.6141629103,127.0676260739
08605,성북레포츠타운,86,80,166,37.6100821203,127.0703008849
08606,석관고,8,10,18,37.610065,127.067226
08657,미아사거리전철역,421,582,1003,37.6123270172,127.0297023033
08662,길음시장입구,504,93,597,37.605175,127.022454
08714,정든마을,29,3,32,37.6094586262,127.0073021258
08715,국민은행장위동지점,134,47,181,37.6135767647,127.048192117
08716,고대사거리,28,77,105,37.5862774378,127.032286944
08718,한성대입구역2번출구,871,233,1104,37.5885307766,127.0067963836
08720,고산초남측,0,4,4,,
08721,고산초남측,244,66,310,37.5877945813,127.0068903011
08722,개운초등학교,20,54,74,37.6013301158,127.0288153961
08727,브라운스톤,143,70,213,37.5995443971,127.0175918525
08728,그린마트,0,18,18,37.5980964627,127.0309919428
08731,래미안610동앞,19,100,119,37.605554924,127.0222829921
08733,수보약국,31,7,38,37.6086862377,127.007874243
08734,쌍다리,18,61,79,37.5934247138,126.9958836268
08744,녹십자약국,497,151,648,37.5896344415,127.0092820358
08745,삼선교제2시장,77,35,112,37.5877791457,127.0086669439
08748,종암래미안,54,26,80,37.6017407751,127.0297680319
08749,힐스테이트,53,22,75,37.599802358,127.0170331603
08750,현대백화점,225,153,378,37.6083206204,127.0293255215
08751,래미안609동앞,80,282,362,37.6065398941,127.0218415618
08757,오렌지마트,4,39,43,37.6113614529,127.0093640245
08758,정릉시장입구,13,29,42,37.6082706923,127.0098053714
08759,용광교회,3,109,112,37.5925307938,126.9948588415
08760,삼영탕앞,20,23,43,37.5888116861,127.0100292895
08765,성북세무서앞,128,85,213,37.5881655969,127.0101254524
08766,종암아이파크1차후문,37,23,60,37.6021839366,127.0304477445
08767,우성APT정문,51,57,108,37.6006018719,127.0152065619
08769,길음2동주민센터,48,29,77,37.6066792098,127.0278026247
08770,래미안501동앞,97,683,780,37.6086973016,127.020692544
08771,북정마을삼거리,2,78,80,37.5925495961,126.9925917473
08772,성북세무서앞,19,74,93,37.5878763191,127.010448131
08773,본교회앞,51,96,147,37.5886421351,127.0116236224
08775,성북소방서,21,16,37,37.6025734873,127.0309356235
08780,장위119안전센터,13,64,77,37.615128,127.058557
08781,석계역,1361,971,2332,37.6146287295,127.0647168159
08783,길음전철역,703,130,833,37.604236,127.024372
08786,길음1동주민센터.길음중앙새마을금고앞,65,618,683,37.609922941,127.0197436999
08787,국민은행사거리,22,141,163,37.6137056129,127.0482091911
08788,슈퍼앞,8,64,72,37.5931263008,126.9927207864
08789,한성대입구사거리,8,127,135,37.5858614419,127.0109053037
08790,고려삼계탕,115,212,327,37.5896248782,127.0147162769
08791,종암아이파크1차정문,18,15,33,37.6035229732,127.0303644793
08792,꿈의숲대명루첸아파트,168,13,181,37.6197496401,127.0480041459
08795,돈암힐스테이트.코오롱하늘채,59,37,96,37.5985154642,127.0142623966
08796,고려슈퍼,1,211,212,37.5986595673,127.0276682695
08797,장위3동주민센터,5,17,22,37.6165801077,127.0571250268
08798,새생명교회,46,629,675,37.6109999704,127.0183054636
08799,돈암코오롱하늘채.일신휴먼빌,2,141,143,37.5995992222,127.0113466683
08800,서경대정문.대일외고,160,6,166,37.613125159,127.0130249816
08801,북정경로당,50,78,128,37.5926486034,126.9909757805
08807,법화사,1,48,49,37.5845908968,127.0109979664
08808,범양APT입구,12,78,90,37.6039526599,127.0272103996
08809,선잠로3길입구,0,39,39,37.5959526063,126.9972123529
08810,선잠로3길입구,43,0,43,37.596027983,126.9968838263
08815,원진프라자앞,11,30,41,37.5995439814,127.0329450077
08819,대우APT정문.대림APT후문앞,67,1085,1152,37.61229132,127.0176895841
08821,선잠단지.성락원앞,11,115,126,37.5947299049,126.9989242882
08822,선잠단지.성락원앞,71,7,78,37.5945947562,126.9989214593
08823,북정마을삼거리.모정앞,64,3,67,37.5923603438,126.9922226001
08824,성북동성당,0,37,37,37.5954461773,126.9977806154
08825,성북동성당,28,1,29,37.5954754571,126.9976560572
08826,성북빌리지,1,52,53,37.5967146098,126.9966104959
08827,성북빌리지,51,0,51,37.5966512245,126.9965774499
08828,한양슈퍼앞,1,62,63,37.5835870776,127.0110533004
08829,돈암초등학교,221,75,296,37.5915399594,127.0123873098
08830,길음역,403,361,764,37.6044477074,127.0256430693
08831,북악슈퍼,0,68,68,37.5975084085,126.9949423033
08832,래미안장위퍼스트하이아파트,233,212,445,37.6195039893,127.0505518894
08833,북악슈퍼,42,0,42,37.5975408896,126.9948250653
08834,우리랜드사우나,134,146,280,37.6167081324,127.0561269978
08835,대우APT211동앞,13,862,875,37.613075,127.016919
08836,용광교회,57,3,60,37.5924406819,126.9947886382
08837,길상사,6,166,172,37.5983184366,126.9938901546
08838,수협동소문동지점,447,66,513,37.5904336247,127.0102797636
08839,길상사,161,4,165,37.598274,126.993744
08840,정릉꿈에그린아파트,0,104,104,37.6015704448,127.0115042175
08842,정릉꿈에그린아파트,78,5,83,37.6015704448,127.0112628186
08843,아리랑시장,6,75,81,37.6024197844,127.0114966535
08844,아리랑시장,105,1,106,37.6022616471,127.0113725526
08845,중앙하이츠빌아파트,3,82,85,37.6025545235,127.0107922182
08846,세계문화유산정릉,243,192,435,37.6015365015,127.0096709641
08847,정릉꿈에그린1단지,62,0,62,37.6021750047,127.0108956099
08848,일신휴먼빌.우정아파트,2,84,86,37.6000835088,127.0113042765
08849,돈암코오롱하늘채아파트,171,14,185,37.5988806852,127.0113125874
08850,돈암코오롱하늘채아파트,9,224,233,37.5987928328,127.0113720246
08854,힐스테이트입구,31,70,101,37.6065115165,127.0281286376
08855,한국가구박물관입구,3,43,46,37.5992909467,126.9926082763
08856,우리옛돌박물관.정법사,65,101,166,37.600604,126.99003
08858,한국가구박물관입구,45,0,45,37.5997706972,126.9921864081
08868,관문약국,31,61,92,37.6158597012,127.0552994399
08872,쌍다리,68,2,70,37.5933823665,126.9959968718
08873,삼선교,1734,211,1945,37.5891741149,127.0074486831
08874,현대백화점별관주차장,282,147,429,37.6075367209,127.0291417258
08876,세광빌라,27,45,72,37.6149094357,127.0544842868
08877,간대어린이공원,1,191,192,37.6186378364,127.0511834599
08878,돌곶이역2번출구,17,654,671,37.6115075259,127.0561739802
08881,성가복지병원앞,22,19,41,37.6059394924,127.0311141214
08883,꿈의숲코오롱하늘채아파트,20,32,52,37.6191413885,127.0456141233
08884,어해랑앞,143,66,209,37.614046655,127.0526527202
08886,고대병원,480,202,682,37.5864829118,127.0262501333
08888,한신103동앞,15,383,398,37.5920233074,127.0082088116
08889,성북소방서,31,49,80,37.6027999972,127.031525069
08892,장위시장,163,138,301,37.6134406042,127.0505764271
08893,생명의전화로터리,106,163,269,37.6038353025,127.0378090878
08894,정릉시장입구.정릉약국,29,36,65,37.608370718,127.0097442213
08895,꿈의숲동문앞,2,47,49,37.6209240431,127.0458244048
08896,꿈의숲대명루첸아파트,12,11,23,37.6193829059,127.0469646561
08897,종암아이파크1차후문,32,57,89,37.602206504,127.0302914603
08898,돈암힐스테이트.코오롱하늘채,90,74,164,37.5987916924,127.0143670046
08900,자산약국.월곡전철역입구.6호선,103,180,283,37.6041727102,127.0393382553
08901,수보약국,14,73,87,37.608704248,127.0080441437
08904,종암래미안,8,66,74,37.6018588018,127.0298303694
08908,장위천주교앞,59,56,115,37.6123942977,127.0487837637
08909,월곡시장.동덕여대오거리,609,303,912,37.6041273834,127.0427144806
08910,정든마을,10,58,68,37.6096167331,127.0073694927
08911,용문중고교,101,115,216,37.58776,127.023075
08912,개운초등학교,11,74,85,37.601682,127.02905
08913,우성APT정문,30,88,118,37.6004509363,127.0152061932
08914,나약국,32,199,231,37.614294786,127.0414527557
08915,GS25장위제일점,86,41,127,37.6110537358,127.0481667022
08916,월곡로데오거리,8,53,61,37.6048993942,127.0438728583
08917,대동슈퍼,1,91,92,37.6111778561,127.0058854907
08919,한진206동앞,1,183,184,37.5954940982,127.0107232511
08920,죽림정사앞,70,91,161,37.5996513018,127.0291748905
08921,쌍용APT,14,204,218,37.6000277168,127.0164193819
08922,슈퍼앞,2,132,134,37.6156500659,127.0423241257
08923,이지마트,10,23,33,37.6099870685,127.0476291248
08924,동아아파트정문앞,45,223,268,37.6068870252,127.0461343399
08925,수녀원입구,0,13,13,37.6118951367,127.0055480005
08926,성신여대평생교육원,49,110,159,37.5893438185,127.0202580181
08927,명신초.삼선푸르지오.힐스테이트,2,462,464,37.5822593867,127.0145993366
08928,브라운스톤,85,374,459,37.5992976541,127.0176785796
08930,동아아파트,1,99,100,37.6080318541,127.0472756242
08931,월곡중학교입구,98,120,218,37.6075912815,127.0471292345
08934,돈암시장,128,93,221,37.5913019518,127.0134834289
08935,창신쌍용2단지.한성대후문,6,1019,1025,37.5813963581,127.0127354927
08936,고명중고교,44,47,91,37.5984610236,127.02029673
08937,상월곡역,0,126,126,37.6068638336,127.0478038236
08938,월곡초교,25,134,159,37.6091289096,127.0461798986
08939,산장아파트,7,66,73,37.616608793,127.0034685688
08941,성북구청.경동고입구,258,57,315,37.5878015805,127.0175977286
08942,한신301동앞,3,328,331,37.5962151136,127.0089861462
08943,낙산삼거리,2,512,514,37.5802801396,127.0103598878
08945,풍림아파트,98,89,187,37.5974334637,127.022078987
08946,월곡중학교,20,20,40,37.6067975857,127.0488367104
08947,월곡초등학교후문,16,159,175,37.6113791943,127.0454756183
08948,도광사,0,2,2,37.6154320192,127.0013581804
08949,경동고앞,22,92,114,37.5870414318,127.0149048675
08950,구민회관201동앞,0,109,109,37.5954999855,127.0091043886
08951,현대홈마트,12,17,29,37.5977742664,127.0328694828
08952,풍림아파트.성신초교,100,227,327,37.595269765,127.0230545241
08953,누구나교회,33,152,185,37.6119083534,127.0448959944
08954,넓은마당,0,6,6,37.6146859282,126.9997383348
08956,삼선노인정,24,101,125,37.5863747515,127.0138720583
08957,한신113동앞,0,116,116,37.5944634325,127.0085261637
08958,종암아이파크2차정문,23,24,47,37.596973297,127.0325169289
08959,개운중학교,12,57,69,37.5940465738,127.0250868706
08960,태광빌라,13,83,96,37.6122936821,127.043916285
08961,삼선초교,0,62,62,37.5851065492,127.0134135316
08962,동구고등학교후문,1,418,419,37.5937038561,127.0084192423
08964,극동아파트후문,24,12,36,37.596016114,127.0333330207
08965,성북구의회,25,53,78,37.5944860839,127.0261062172
08966,장위1동노인정,11,99,110,37.6116143881,127.043044981
08969,극동아파트정문,7,32,39,37.5954193263,127.0342670319
08970,고려대아이스링크,31,52,83,37.5929132964,127.0278065619
08971,하트마트편의점,44,144,188,37.6120812083,127.0415425301
08972,선경아파트,8,78,86,37.5943641285,127.0343480838
08973,고려대안암학사,20,59,79,37.5912538614,127.029975612
08975,종암중학교,2,28,30,37.5932304366,127.0347676921
08976,고려대법과대학.한국어교육관입구,1,60,61,37.591334,127.033307
08977,해병대전우회,4,129,133,37.5924290939,127.0356891028
08979,성북세무서앞,63,242,305,37.5879222642,127.0105659012
08980,꿈의숲대명루첸아파트,165,192,357,37.6208195823,127.0456216446
08981,래미안세레니티,120,147,267,37.5990565246,127.0294147509
08982,양광교회.죽림정사앞,91,132,223,37.5995701571,127.0293639897
08983,석관동주민센터,64,258,322,37.6129858688,127.0613211365
08984,한신105동앞,14,513,527,37.5926731519,127.0090298604
08985,한신108동앞,1,340,341,37.5935739534,127.0094244147
08986,스카이프라자앞.111동앞,66,766,832,37.5945110389,127.010411688
08987,한진207동앞,3,307,310,37.5963140934,127.0106667452
08988,한진202동앞,3,597,600,37.5965292419,127.0096986249
08989,한진204동앞,913,11,924,37.5964459011,127.0096872905
08990,한진207동앞,231,7,238,37.5963571148,127.0104211977
08991,스카이프라자앞.111동,425,13,438,37.5947555941,127.0104114676
08992,한신108동앞,145,8,153,37.5939786975,127.0096419085
08997,삼선동주민센터,1765,972,2737,37.5910090068,127.0142590636
09001,수유3동우체국,2179,1998,4177,37.6413456809,127.0291614982
09002,수유3동우체국,1215,1715,2930,37.6408930184,127.0288270779
09003,수유역.수유사거리,2098,1737,3835,37.6365085542,127.024004631
09004,수유역.강북구청,8470,8324,16794,37.6375917165,127.0253079045
09005,수유시장.성신여대미아캠퍼스앞,4862,3521,8383,37.6312262117,127.0241719892
09006,수유시장.성신여대미아캠퍼스앞,4035,4001,8036,37.6303501914,127.024614399
09007,미아역.신일중고,3189,2519,5708,37.6248696784,127.0266493048
09008,미아역.신일중고,2763,3370,6133,37.6242950292,127.0270450398
09009,도봉세무서.성암국제무역고,2777,2434,5211,37.6197140913,127.028719403
09010,도봉세무서.성암국제무역고,1662,2887,4549,37.6188372063,127.0292480892
09011,미아사거리역,7014,6165,13179,37.6137621245,127.0299325391
09012,미아사거리역,8803,8191,16994,37.6128943078,127.0302131064
09013,수유역.강북구청,5674,6327,12001,37.6382895216,127.0258703828
09102,우이동도선사입구.북한산우이역,496,417,913,37.6626545921,127.0127134568
09103,우이동성원아파트,532,85,617,37.660809,127.013424
09104,우이동성원아파트,75,430,505,37.662045,127.013357
09105,진성빌라사거리,653,190,843,37.659690941,127.013759831
09106,서라벌중학교.우이동대우아파트,1259,382,1641,37.6550975836,127.0129303177
09107,덕성여대솔밭근린공원,1040,461,1501,37.6513809333,127.0126091716
09108,4.19민주묘지역,883,391,1274,37.6491109904,127.0137114618
09109,4.19민주묘지역,287,1091,1378,37.649113,127.014019
09110,국립4.19민주묘지입구사거리,447,885,1332,37.648147,127.013448
09111,국립4.19민주묘지입구사거리,779,217,996,37.64803,127.013707
09112,국립419묘지삼거리.윤극영가옥,205,452,657,37.64653,127.010438
09113,국립419묘지삼거리.윤극영가옥,222,197,419,37.6463224596,127.0106931578
09114,인수동백운교회입구,630,402,1032,37.644587883,127.0106566466
09115,인수동백운교회입구,584,405,989,37.644309423,127.0109421731
09116,인수중학교,483,219,702,37.6425036675,127.010828591
09117,인수중학교,403,524,927,37.6423108154,127.0110529305
09118,서울영어마을수유캠프국립재활원입구,439,222,661,37.6400512667,127.0119023303
09119,서울영어마을수유캠프국립재활원입구,204,403,607,37.6403058,127.011851385
09120,인수동장미원,1110,496,1606,37.6450333774,127.0155272484
09121,인수동장미원,405,590,995,37.6445998945,127.0159997041
09122,가오리역,1085,380,1465,37.64188,127.016555
09123,가오리역,604,1318,1922,37.6416805827,127.0168113608
09124,강북청년창업마루,295,800,1095,37.646853,127.01746
09125,강북청년창업마루,1299,328,1627,37.6467578286,127.0170948735
09126,수유2동주민센터우이시장,1758,415,2173,37.6450886664,127.019428906
09127,수유2동주민센터우이시장,396,1407,1803,37.644893,127.020202
09128,광산사거리,1262,699,1961,37.6433654819,127.0217661991
09129,광산사거리,498,1527,2025,37.643651517,127.021916414
09130,우이초등학교후문,245,166,411,37.6383971504,127.0136267756
09131,우이초등학교후문,128,206,334,37.6384286647,127.0138284749
09132,인수동청수탕입구,346,130,476,37.6371680139,127.0128648965
09133,인수동청수탕입구,197,369,566,37.6365184578,127.0130723558
09134,우이초등학교,1007,211,1218,37.6365089299,127.0171140536
09135,우이초등학교,254,660,914,37.63681,127.017357
09136,화계사입구.한신대학교대학원,185,214,399,37.6339738966,127.013957617
09137,화계사입구.한신대학교대학원,540,200,740,37.6337259037,127.0139522376
09138,수유동삼양탕앞,106,429,535,37.63408,127.015551
09139,수유동삼양탕앞,254,149,403,37.6338204001,127.0149108072
09140,화계사입구사거리,196,451,647,37.6342866157,127.016899104
09141,화계사입구사거리,295,198,493,37.6339931438,127.0168721385
09142,강북노인종합복지관,315,770,1085,37.6344334502,127.0189955726
09143,강북노인종합복지관,814,421,1235,37.634217125,127.0191414322
09144,신일병원,807,964,1771,37.6347226913,127.0222678339
09145,신일병원,662,990,1652,37.6343871166,127.0212163361
09146,강북구청,1510,2742,4252,37.640412,127.02602
09147,강북구청,2194,1325,3519,37.6406143243,127.0262068516
09148,강북경찰서입구,154,459,613,37.6351433469,127.0286868166
09149,강북경찰서입구,233,393,626,37.6349869893,127.0291221925
09150,북부시장입구,598,379,977,37.6354345171,127.0318782573
09151,북부시장입구,326,333,659,37.6351732556,127.0322955083
09152,번동사거리,105,169,274,37.6361251293,127.0350310027
09153,번동사거리,374,297,671,37.6356319935,127.0345096148
09154,북부수도사업소,831,485,1316,37.6342350364,127.0361604414
09155,북부수도사업소,858,287,1145,37.6349568396,127.0352743398
09156,수유보건지소,460,272,732,37.6333403549,127.0174696835
09157,수유보건지소,143,579,722,37.6332538827,127.0177047638
09158,빨래골입구.수유1동주민센터,1168,510,1678,37.629858846,127.017765125
09159,빨래골입구.서울수유초등학교,413,934,1347,37.630007,127.017982
09160,롯데마트삼양점.래미안1차아파트,1095,714,1809,37.6252947897,127.0182240004
09161,롯데마트삼양점.래미안1차아파트,830,936,1766,37.6254702234,127.0184390605
09162,삼양초등학교,433,271,704,37.6232424458,127.0189878991
09163,삼양초등학교,219,519,738,37.623407,127.019088
09164,삼양사거리역,533,383,916,37.6218299513,127.0201740841
09165,삼양사거리역,376,471,847,37.62151722,127.0205867332
09166,삼양동사거리.래미안트리베라,1402,860,2262,37.6180883036,127.0213079919
09167,삼양동사거리.래미안트리베라,578,823,1401,37.6185334123,127.0214576496
09168,송천초등학교.미아뉴타운입구,772,411,1183,37.6154596915,127.0221103696
09169,송천초등학교.미아뉴타운입구,397,1132,1529,37.6140963114,127.0223138592
09170,삼양동사거리,369,880,1249,37.6191558802,127.0223396475
09171,삼양동사거리,1136,577,1713,37.6191447206,127.0217902854
09172,성암국제무역고등학교,423,677,1100,37.6183241886,127.0249842203
09173,성암국제무역고등학교,570,383,953,37.6179423926,127.0255230955
09174,삼양입구사거리,614,557,1171,37.6172887669,127.0283809304
09175,삼양입구사거리,164,1468,1632,37.61706,127.028487
09176,강북보건소,624,232,856,37.6322518875,127.0390339762
09177,신창교,218,171,389,37.633285201,127.0385729384
09179,강북보건소,218,418,636,37.632478,127.039233
09180,번동주공4단지,171,111,282,37.6313780406,127.0399848073
09181,초안교,167,530,697,37.63111,127.04109
09182,번동주공3단지,586,106,692,37.6290195783,127.0434628856
09183,번동주공3단지,160,309,469,37.628652,127.044375
09184,번동주공1단지,344,153,497,37.6255071471,127.048129578
09185,번동주공1단지,142,384,526,37.627015,127.047227
09186,오현초등학교,1192,840,2032,37.6234130879,127.0479843518
09187,북서울꿈의숲,583,240,823,37.6191713406,127.0442546555
09188,송중동한일유엔아이,176,559,735,37.6137499056,127.0379534336
09189,창문여고앞,1123,1011,2134,37.611997767,127.0354111524
09190,숭곡초등학교입구,993,1866,2859,37.6100221835,127.0318277681
09194,강북청소년센터,901,1,902,37.6456670533,127.0068382647
09195,강북청소년센터,60,780,840,37.6457796797,127.0067787872
09196,국립4.19민주묘지,449,62,511,37.6468996874,127.0091441274
09197,국립4.19민주묘지,54,488,542,37.64695,127.008957
09198,강북중학교,218,221,439,37.6448419212,127.0235480508
09199,한성운수차고지,52,366,418,37.634381273,127.036703825
09200,광산사거리,39,116,155,37.6425235501,127.0229920646
09201,광산사거리,321,211,532,37.643844513,127.0231023914
09203,수유중앙시장,246,227,473,37.6403601066,127.0227228438
09205,대한병원,508,246,754,37.6367337539,127.0231692841
09206,삼성화재강북지점,377,1360,1737,37.6355100656,127.0248073406
09207,강북구청사거리,421,309,730,37.638748,127.028345
09208,강북구청사거리,151,582,733,37.638982,127.028612
09209,수송초등학교,168,446,614,37.636832,127.031455
09210,수송초등학교,586,257,843,37.636998,127.031647
09211,수유중학교혜화여고,767,267,1034,37.6321134046,127.0135834136
09212,혜화여고,352,453,805,37.6319759796,127.013795806
09213,서울정인학교,272,281,553,37.6292133906,127.013001965
09214,우광타운,145,343,488,37.6292978747,127.013126928
09215,구세군강북종합사회복지관입구,341,567,908,37.6247738195,127.0123860255
09216,구세군강북종합사회복지관입구,370,363,733,37.62492,127.012504
09217,솔샘중고등학교.팔팔.미송경로당,370,817,1187,37.623368,127.013138
09218,솔샘중고등학교.팔팔.미송경로당,407,251,658,37.6232608308,127.0130269844
09219,동북프라자,817,416,1233,37.6198863577,127.0184178589
09220,동북시장,1442,996,2438,37.6199944163,127.0187973439
09221,두산위브아파트입구,701,378,1079,37.6200218233,127.0162572448
09222,두산위브아파트입구,390,445,835,37.6201498963,127.0161949742
09223,삼각산동SK아파트북한산시티미양초등학교,1019,409,1428,37.6201843608,127.0133943451
09224,삼양동벽산라이브파크미양초등학교,513,790,1303,37.6203083333,127.0126071297
09225,SK아파트.벽산아파트상가,452,294,746,37.6197323732,127.0111968544
09226,SK아파트.벽산아파트상가,363,757,1120,37.6199369055,127.0113418872
09227,솔샘터널,308,219,527,37.6187769661,127.0092342783
09228,번동주공아파트3단지4단지,233,18,251,37.6293796927,127.0399359248
09229,번동주공아파트3단지4단지,39,208,247,37.63011,127.041138
09230,번동초등학교,48,84,132,37.6289388579,127.0398418797
09231,번동한솔솔파크,61,338,399,37.627663862,127.0382810784
09232,번동한솔솔파크,255,49,304,37.6275338363,127.037812026
09233,번동해모로아파트,35,26,61,37.6263750938,127.0368164778
09234,번동해모로아파트,372,60,432,37.6268511292,127.0370034124
09235,강북문화정보도서관,47,62,109,37.6252315157,127.0372886392
09236,강북문화정보도서관,454,91,545,37.6253893015,127.0369290562
09237,동문굿모닝힐,27,28,55,37.6235474611,127.0377556282
09238,동문굿모닝힐,49,10,59,37.623740389,127.0374543779
09239,북서울꿈의숲서문,56,52,108,37.6225842756,127.0375263014
09240,꿈의숲롯데캐슬아파트,133,277,410,37.6179925377,127.0358153703
09241,꿈의숲롯데캐슬아파트,370,137,507,37.6185988921,127.0359374797
09242,경남아너스빌.꿈의숲해링턴아파트,163,323,486,37.6164972882,127.0345036012
09243,경남아너스빌.꿈의숲해링턴아파트,229,140,369,37.6167487855,127.0345744355
09244,송중초등학교,655,470,1125,37.6164216339,127.031162228
09245,송중초등학교,144,1122,1266,37.6165541394,127.0316486841
09246,수유3동우체국,91,499,590,37.6400256713,127.0275793554
09247,수유3동우체국,415,137,552,37.6400597793,127.0281157885
09248,수유역.노스페이스문화센터,2606,829,3435,37.6389518521,127.026897397
09249,수유역6번출구,1718,1473,3191,37.6376933332,127.0250607476
09253,미아역8번출구.신일중고,8,181,189,37.627378539,127.025544449
09255,영신여객차고지,695,5,700,37.662868,127.011523
09256,영신여객차고지,3,743,746,37.6629182765,127.0112627968
09260,미아사거리역,24,128,152,37.6153850288,127.0297349566
09261,미아사거리역,606,452,1058,37.6105034099,127.0305298034
09263,한신대학교,435,114,549,37.635375886,127.0130710226
09266,수유사거리,227,201,428,37.6346209227,127.0243325744
09267,수유사거리,142,596,738,37.6349248841,127.0249133041
09269,송중동주민센터앞,48,22,70,37.6160580688,127.0333691522
09270,송중동경남아너스빌정문,193,85,278,37.6133360851,127.0340715248
09271,북서울꿈의숲서문,18,178,196,37.6227175379,127.0378333766
09272,수유역.강북구청,816,1659,2475,37.6386311446,127.0260514034
09273,삼각산보건지소,159,246,405,37.617673,127.015438
09274,삼각산보건지소,249,383,632,37.6174683906,127.0152813623
09275,삼각산동삼각산아이원아파트후문,158,536,694,37.616347829,127.0188312494
09276,삼각산동삼각산아이원아파트후문,526,243,769,37.6162710915,127.0187454371
09277,롯데백화점미아점,1279,4996,6275,37.614709413,127.0307561737
09278,우이동주민센터입구,56,114,170,37.6476640054,127.0123580949
09283,솔샘터널,130,325,455,37.6187431808,127.0092116202
09286,우이동도선사입구,166,22,188,37.6627897127,127.0129571525
09289,우이동차고지기점,392,34,426,37.663032,127.011738
09290,한성운수종점,1,480,481,37.634618,127.035297
09291,화계사입구.종점,198,132,330,37.632628,127.013707
09293,SK아파트벽산아파트상가,582,246,828,37.6196972385,127.0111164185
09294,우이동차고지종점,1,432,433,37.663129,127.012147
09295,삼각산동삼각산아이원아파트정문,370,403,773,37.6161778465,127.0166880013
09298,삼각산동삼각산아이원아파트정문,156,652,808,37.616358098,127.0164422295
09302,삼각산고.래미안트리베라,270,398,668,37.6144302952,127.0218143938
09303,삼각산고.래미안트리베라,131,67,198,37.6144686987,127.0212027862
09304,방천시장입구,207,461,668,37.6111758164,127.0330881115
09305,화계사입구.한신대학교대학원,52,278,330,37.633257,127.01343
09306,미아사거리역.롯데백화점,848,161,1009,37.6140792311,127.0302283114
09307,삼각산119안전센터,174,277,451,37.619549299,127.0151790977
09308,삼각산119안전센터,11,71,82,37.6197921935,127.0153453647
09310,무량사입구,383,14,397,37.6462100417,127.00794393
09311,무량사입구,1,477,478,37.646323,127.007842
09312,꿈의숲주차장입구,522,385,907,37.6208649775,127.0453126023
09313,수유중앙시장,431,211,642,37.6408936108,127.0223875946
09314,대한병원,111,324,435,37.6368331317,127.0228830982
09500,우이동,200,130,330,37.6634309704,127.0122904688
09501,미송경로당,298,36,334,37.6241772665,127.0127201301
09502,번동초교.솔그린APT.하나은행,2502,222,2724,37.6289921152,127.0395643313
09503,영암마트,121,178,299,37.6289011321,127.0303510091
09504,빨래골,86,1,87,37.6274393769,127.01017946
09505,본원정사,38,0,38,37.6381013089,127.0063793815
09506,아카데미하우스.통일교육원,105,2,107,37.6420400906,127.0020125009
09507,성원아파트,109,2,111,37.6610980709,127.0133988593
09510,번동슈퍼,50,40,90,37.627648264,127.0378426735
09512,동아할인마트,80,1,81,37.6278746042,127.0310972055
09513,수연슈퍼,170,1,171,37.6277190796,127.0113566058
09514,모아빌라,37,0,37,37.638200457,127.0074386095
09515,신성빌라,70,1,71,37.6435025092,127.003531011
09516,송중동주민센터,43,65,108,37.6161085295,127.0333691747
09517,스카이빌,62,10,72,37.6249774078,127.0129139934
09518,청화슈퍼,127,105,232,37.6278189463,127.036646366
09520,믿음슈퍼,123,4,127,37.6270885851,127.0321221868
09521,다리앞,73,0,73,37.6278825764,127.0122018705
09522,해청빌라,45,2,47,37.6375342546,127.0076913639
09523,백련사,60,4,64,37.6441927035,127.0045157924
09525,구세군강북종합사회복지관,239,18,257,37.6251665309,127.0138350809
09526,교육촌경로당,277,144,421,37.6271601364,127.0356413496
09528,당진슈퍼,361,18,379,37.6255754824,127.0323057443
09529,삼흥연립,121,0,121,37.628083771,127.013344785
09530,기도원입구,29,0,29,37.6370107775,127.0079137924
09531,강북청소년센터,116,25,141,37.6456973855,127.0070203007
09532,마을버스사무실,136,7,143,37.6252573458,127.015405311
09533,영순슈퍼,275,196,471,37.6266121006,127.0344605841
09534,동문굿모닝힐,136,29,165,37.6238998772,127.0374657868
09535,삼광학원,231,37,268,37.6244988638,127.0321493948
09536,한빛맹아학교,309,6,315,37.6287112892,127.0152179897
09537,형제슈퍼,252,1,253,37.6366827714,127.0098045717
09539,쌍문교,491,75,566,37.6461780008,127.0246386377
09540,페리카나치킨,71,35,106,37.625406772,127.01654052
09541,당진슈퍼,430,276,706,37.6255924772,127.0325364143
09543,동성마트,110,35,145,37.6236275055,127.0321875376
09544,한빛예술단,70,22,92,37.6293965888,127.0162904401
09545,삼성하이츠빌라,289,2,291,37.6367334755,127.0110180881
09546,도일타운,114,4,118,37.6367536584,127.0119357932
09547,강북중학교,386,107,493,37.6445347047,127.023286184
09548,삼양시장,151,69,220,37.6250705419,127.0174161828
09550,한영교회,93,27,120,37.623077793,127.0323753581
09551,수유1동주민센터.파출소,226,76,302,37.6301526349,127.0175250022
09553,광산사거리,105,326,431,37.6424802856,127.023056642
09554,삼양파출소,142,63,205,37.6248776198,127.0180165771
09556,제일슈퍼,173,13,186,37.6221991545,127.0326717873
09557,하나은행,222,6,228,37.6309112824,127.0179523198
09558,청수탕,291,11,302,37.6367446746,127.0126565535
09560,강북구청,417,1060,1477,37.6403810594,127.0259840261
09561,삼양오거리.삼양동주민센터,139,48,187,37.6247891837,127.0188481065
09562,도일타운,4,202,206,37.6369021524,127.0118237871
09563,홈빌라트,114,28,142,37.62124033,127.0329273916
09564,광성슈퍼,120,29,149,37.6321483624,127.0186380913
09566,인수초중학교,26,14,40,37.6435561341,127.0107834163
09567,수유역,3570,3079,6649,37.6375906296,127.0249677991
09568,오현초등학교,79,147,226,37.6235355369,127.0459678973
09569,자이홈타운,144,72,216,37.6248635854,127.0211399902
09571,꿈의숲해링턴아파트101동앞,248,34,282,37.6201373335,127.0331749954
09572,화계유치원,29,40,69,37.6338728904,127.019526826
09573,한신대신학대학원.화계사,251,32,283,37.6337304054,127.0139839635
09576,주공1.2단지한진아파트,265,281,546,37.6253372712,127.0447499944
09577,삼양신협,8,201,209,37.6254173467,127.0232915478
09578,번3동주민센터,133,182,315,37.6261592427,127.0466039503
09579,미아사거리전철역,2811,586,3397,37.6128683546,127.0304262542
09580,꿈의숲해링턴105동.강북50플러스센터,357,59,416,37.6183851236,127.0335841655
09582,삼양탕,123,100,223,37.6338294026,127.0149765253
09583,국립재활원,185,36,221,37.6402544989,127.0115682035
09585,신원아파트.북서울꿈의교회,289,247,536,37.6261160053,127.044224785
09586,미아역6번출구,3,1024,1027,37.625939543,127.0253864806
09588,꿈의숲해링턴아파트108동앞,75,92,167,37.6166641214,127.033985486
09589,북한산스카이빌딩,53,589,642,37.6356860225,127.0236086128
09590,송암교회.화계사거리.수유보건지소,137,192,329,37.6339778333,127.016816616
09591,강북구의회.강북문화예술회관,233,83,316,37.6403416065,127.0142820851
09592,경남아너스빌정문,60,69,129,37.6130688648,127.0344291798
09593,기산아파트.2단지후문,287,143,430,37.6276136002,127.0442392677
09594,미아역7번출구,1526,365,1891,37.6267385325,127.0258341771
09595,수유역,2358,2068,4426,37.6374815091,127.0253881411
09597,가오리,147,108,255,37.6406305942,127.016284405
09598,송중동주민센터,34,94,128,37.6159868107,127.0336239934
09599,쌍문교,47,341,388,37.6456427714,127.0245795335
09600,주공3단지정문,252,188,440,37.6282486714,127.0423068222
09631,미아역6번출구,221,20,241,37.6260467836,127.0253321368
09642,8번지입구,51,236,287,37.440965,126.45723
09656,번동삼거리,164,82,246,37.6350975692,127.0279469112
09682,벽산아파트,70,62,132,37.6409823569,127.0199332209
09717,한양아파트입구.삼덕상운,283,255,538,37.6279896285,127.0409777233
09718,삼양신협,72,84,156,37.6256382551,127.0235196961
09739,미아사거리역2번출구,2647,665,3312,37.613858,127.030812
09753,양지빌라,40,140,180,37.6150510498,127.0380243258
09754,성당앞,19,75,94,37.6422570137,127.0220299226
09760,하나은행.새마을금고,512,288,800,37.6287446347,127.0395277612
09769,북서울자이폴라리스입구,75,175,250,37.6251048164,127.0214408606
09770,8번지슈퍼,91,134,225,37.6158503081,127.0380371932
09771,롯데백화점,1400,135,1535,37.6144552857,127.0309377135
09773,중앙시장,20,175,195,37.6403898489,127.0224706365
09774,강북구민운동장.4단지,387,195,582,37.630107976,127.0385973548
09775,삼양오거리.삼양동주민센터,101,243,344,37.624899112,127.0188730581
09776,산장빌라,43,61,104,37.6164279001,127.0380476824
09777,화계유치원,56,145,201,37.6339936682,127.0193274421
09779,강북보건소.번2동주민센터,352,108,460,37.631544792,127.0370685406
09780,삼일약국.롯데마트,488,128,616,37.6250378278,127.0179320311
09781,삼우하이츠빌라,25,81,106,37.6160812447,127.0372251142
09782,꿈의숲해링턴아파트108동앞,85,421,506,37.6167136521,127.0340676265
09783,광성슈퍼,15,218,233,37.6322619376,127.0183911221
09785,금호.현대아파트,243,48,291,37.6318694163,127.0363141169
09786,삼양시장,15,22,37,37.6252316268,127.0173515224
09787,한일아파트후문,149,238,387,37.6154856509,127.0371511878
09788,꿈의숲해링턴105동.강북50플러스센터,44,401,445,37.6183941092,127.0336691211
09789,수유1동주민센터.파출소,155,327,482,37.6304022281,127.0175703804
09790,수유역,1050,235,1285,37.636850809,127.0245853867
09791,로얄공인중계사무소,62,45,107,37.632733949,127.0350081615
09792,페리카나치킨,23,78,101,37.6254842593,127.016582455
09793,장미맨션,63,69,132,37.6147440609,127.0371417568
09794,꿈의숲해링턴아파트101동앞,19,199,218,37.620030966,127.0333154191
09795,한빛예술단,6,121,127,37.6296268423,127.0162720978
09798,주공5단지,220,80,300,37.6333955299,127.0343739731
09799,마을버스사무실,6,164,170,37.6253402419,127.015432518
09800,한일아파트정문,121,37,158,37.6139772435,127.0371221189
09801,홈빌라트,10,176,186,37.6211844276,127.0330531131
09802,한빛맹아학교,1,218,219,37.6287953314,127.015157464
09803,송암교회.화계사거리.수유보건지소,238,170,408,37.6342732728,127.0170113546
09804,백년시장,41,17,58,37.6411606222,127.0253984583
09805,금강산병원.전자공단,55,110,165,37.6344085277,127.0337455976
09806,구세군강북종합사회복지관,18,307,325,37.625303504,127.0137637329
09807,8번지입구,334,20,354,37.613707628,127.0377245997
09808,제일슈퍼,25,164,189,37.6222270573,127.0327828202
09809,삼흥연립,0,73,73,37.6282121507,127.0134410991
09811,성당앞,132,120,252,37.6423669718,127.0218894421
09812,번동5거리.북부노동지청,43,178,221,37.6350464176,127.0340110218
09813,다리앞,0,80,80,37.627969078,127.0122245437
09814,한신대신학대학원.화계사,32,223,255,37.634119725,127.0135376169
09815,벽산아파트,46,118,164,37.6411409504,127.0199139997
09817,초록마트,1,138,139,37.6252901267,127.012515263
09818,방천시장입구,71,277,348,37.6109552133,127.0334019855
09819,한영교회,24,120,144,37.6229939721,127.0325242794
09820,수연슈퍼,0,116,116,37.6278069236,127.0113792758
09821,유진슈퍼,5,183,188,37.63553896,127.0132670716
09822,가오리,171,349,520,37.6407630608,127.0162289098
09824,정은빌라,2,132,134,37.6259965831,127.012449672
09825,미아사거리역,1811,985,2796,37.6127736242,127.0309369798
09826,삼광학원,57,435,492,37.6244222371,127.0322762463
09827,빨래골,4,61,65,37.6274903404,127.0100814183
09828,청수탕,21,313,334,37.6369587608,127.0126679297
09829,강북구의회.강북문화예술회관,36,206,242,37.6404389454,127.014098535
09830,빨래골입구,40,281,321,37.6265516594,127.0123647948
09831,삼성하이츠빌라,2,238,240,37.6368907918,127.011080062
09832,국립재활원,46,251,297,37.6402256236,127.0119761285
09833,성원아파트,18,180,198,37.6617153182,127.0134032107
09834,수유역.강북구청,3182,1676,4858,37.6376399831,127.0259230173
09835,SM빌라,8,50,58,37.6260353485,127.0122706768
09836,믿음슈퍼,3,230,233,37.6271020543,127.0322943991
09837,형제슈퍼,1,216,217,37.6368864275,127.0097995802
09841,당진슈퍼,172,687,859,37.6255168584,127.0327877998
09843,우광슈퍼,0,124,124,37.6280104647,127.0316117026
09844,기도원입구,0,43,43,37.6370738425,127.0079732801
09845,인수초중학교,10,98,108,37.6435398929,127.011019117
09847,솔샘중고등학교,7,272,279,37.6240619418,127.0125898279
09848,영순슈퍼,83,221,304,37.6264670403,127.0345928361
09851,해청빌라,0,65,65,37.6375040721,127.0078345363
09853,벽산아파트,34,149,183,37.619802676,127.0110031514
09854,금강슈퍼,56,227,283,37.6270767404,127.0357113281
09856,모아빌라,0,54,54,37.6382309279,127.0077503725
09857,국립4.19민주묘지삼거리.윤극영가옥,17,63,80,37.6461584609,127.0107157988
09859,청화슈퍼,27,79,106,37.6277765778,127.0367029926
09860,동문굿모닝힐,24,271,295,37.6235952196,127.0377522537
09861,본원정사,18,14,32,37.6381346428,127.0064915618
09863,주공5단지,105,167,272,37.6335857244,127.0341463204
09865,번동초등학교,104,1103,1207,37.6285317388,127.0393340964
09868,로얄공인중계사무소,31,145,176,37.6328106097,127.0347759274
09870,강북문화정보도서관.해모로아파트,36,485,521,37.6258127839,127.0370107352
09872,금호.현대아파트,98,359,457,37.6317369268,127.0364126242
09873,강북보건소앞.번2동주민센터,140,201,341,37.6316563508,127.0376226365
09875,백련사,1,132,133,37.6445864643,127.00480365
09876,강북보건소.번2동주민센터,95,275,370,37.6312689643,127.0373743139
09877,신성빌라,0,152,152,37.6436773202,127.0034868249
09878,강북구민운동장.4단지,103,350,453,37.6300386219,127.0385078133
09880,아카데미하우스.통일교육원,1,83,84,37.6421608368,127.0019309161
09881,번동슈퍼,14,88,102,37.6277177238,127.0376036568
09882,한양아파트입구.삼덕상운,156,216,372,37.627812073,127.0410988513
09883,주공3단지정문,90,211,301,37.6280702834,127.0422330792
09884,기산아파트.2단지후문,167,277,444,37.6277956991,127.0440252483
09885,신원아파트.북서울꿈의교회,304,233,537,37.6259772576,127.0441737213
09886,주공1.2단지한진아파트,122,88,210,37.6249236185,127.0448958911
09887,오현초등학교,54,88,142,37.6230966867,127.0460254038
09888,주공1.2단지한진아파트,44,67,111,37.6252363894,127.0446457062
09890,번3동주민센터,139,152,291,37.6260240521,127.0466752399
09893,현대백화점.E마트.빅토리아호텔,102,277,379,37.6104099192,127.0305163924
09894,미아사거리역.롯데백화점,4118,1138,5256,37.6142392565,127.030133461
09895,광산사거리,208,436,644,37.6434913546,127.0227668587
09896,보람빌딩,137,34,171,37.6348963686,127.0250915337
09897,번동5거리.북부노동지청,102,93,195,37.6350509566,127.0338943188
09898,금강산병원.전자공단,36,135,171,37.6343535824,127.0336730577
09899,하나은행.새마을금고,310,747,1057,37.6285541467,127.0396898577
09903,우이3교,12,100,112,37.6364064842,127.0357080785
09905,당진슈퍼,31,399,430,37.625596726,127.0324720413
09908,삼성래미안아파트,149,77,226,37.6144948223,127.0210554967
09909,성우아파트,36,21,57,37.6174096971,127.0217994295
09913,미아사거리역,5,819,824,37.6150849616,127.029758625
09920,두산위브아파트,89,64,153,37.6190948303,127.0154198988
09934,한영교회,93,8,101,37.6231428162,127.0318418008
09936,달팽이계단,23,14,37,37.6239152351,127.0311295427
09937,대성빌라정문,66,6,72,37.6248327216,127.0304263922
09938,신구한일아파트입구,37,15,52,37.6257429795,127.029785532
09939,실버복지센터,19,25,44,37.6271731261,127.0293711961
09940,남양빌라,3,106,109,37.6269042294,127.0284681063
09941,미아역3번출구,520,384,904,37.6265558405,127.0269767981
09942,미아역1번출구,481,214,695,37.6275568794,127.0258843935
09943,수유시장,177,136,313,37.6321924359,127.0240584476
09944,요진아파트,33,81,114,37.6336246217,127.026553857
09945,우일빌딩앞,94,77,171,37.634811133,127.0274879166
09946,신구한일아파트입구,48,83,131,37.6256574148,127.0296336871
09947,대성빌라정문,6,57,63,37.6248255726,127.0301941441
09948,달팽이계단,33,51,84,37.623820677,127.0309176532
09949,한영교회,5,118,123,37.6231743045,127.0320253405
09950,한국전력공사,383,316,699,37.6305370136,127.0247048513
09994,창문여고앞,847,382,1229,37.6118839664,127.0353820571
10001,도봉산역,2079,706,2785,37.689202857,127.0455120837
10002,도봉산역,574,1107,1681,37.688568,127.045813
10003,도봉한신아파트,1832,261,2093,37.6839229454,127.0459850042
10004,도봉한신아파트,296,1746,2042,37.682672,127.046067
10005,서울북부지방법원.검찰청.도봉역성황당,1375,372,1747,37.6777606492,127.0449581366
10006,서울북부지방법원.검찰청.도봉역성황당,366,1626,1992,37.677262,127.045103
10007,신도봉사거리,932,321,1253,37.673289362,127.044147339
10008,신도봉사거리,285,1011,1296,37.67275,127.044333
10009,도봉소방서.방학역남부,2356,796,3152,37.6661748051,127.0429308393
10010,도봉소방서.방학역남부,1023,2566,3589,37.66567657,127.043051246
10011,도봉보건소,2590,1369,3959,37.6589364195,127.0407623758
10012,도봉보건소.북한산아이파크아파트,954,2082,3036,37.658205,127.040517
10013,도봉구민회관.도봉문화원,2498,2319,4817,37.6545598452,127.0381736668
10014,도봉구민회관.도봉문화원,1257,2079,3336,37.653968,127.037977
10015,쌍문역,3112,6496,9608,37.6488174173,127.0347686574
10016,쌍문역,5292,2319,7611,37.6480714136,127.0344600639
10017,우이1교앞,1666,780,2446,37.6452929962,127.0326524367
10018,우이1교앞,646,1798,2444,37.644652,127.03242
10019,신도봉시장.도봉구청.방학역북부,1752,1133,2885,37.6699992027,127.0436499626
10020,신도봉시장.도봉구청.방학역북부,932,1328,2260,37.669197,127.043757
10103,도봉동한신아파트,175,19,194,37.6826140348,127.0456109086
10104,도봉동한신아파트,0,15,15,37.6821047926,127.0459586654
10105,녹천역,203,142,345,37.643222946,127.0524268652
10107,서울북부지방법원.검찰청.도봉역성황당,145,73,218,37.6771834389,127.0451325639
10108,서울북부지방법원.검찰청.도봉역성황당,442,183,625,37.6770277354,127.0446529158
10109,도봉견인차량보관소,70,196,266,37.6741632354,127.0446001847
10110,도봉견인차량보관소,82,58,140,37.6741048347,127.0441500898
10111,포도원.현대.대림아파트.유한양행,569,191,760,37.6692437083,127.0437945509
10113,도봉소방서,103,335,438,37.6656756185,127.043188402
10114,도봉소방서,224,101,325,37.6651007798,127.0425798048
10115,방학사거리.바로선병원,98,329,427,37.6612173924,127.0422791488
10116,방학사거리,300,138,438,37.6622176747,127.0421039333
10117,도봉보건소,82,63,145,37.6575128224,127.0402286427
10119,함석헌기념관.정의여중고,253,263,516,37.6526308865,127.0373872846
10120,함석헌기념관.정의여중고,196,1229,1425,37.6521851028,127.0365880712
10121,도봉구민회관.도봉문화원,572,342,914,37.6541047846,127.0382221679
10122,도봉구민회관.도봉문화원,528,366,894,37.6548202673,127.0381420661
10124,쌍문역.쌍문시장,2035,4063,6098,37.6480246628,127.0340974005
10126,쌍문역.쌍리단길,6555,2808,9363,37.6475318122,127.0342799955
10127,우이1교앞,412,713,1125,37.643993768,127.0321793259
10129,서울북부지방법원.검찰청.성우아파트,227,128,355,37.676134203,127.048374262
10130,서울북부지방법원.검찰청.성우아파트,242,280,522,37.6758077674,127.0477862346
10131,법조타운공영주차장,233,82,315,37.6747549533,127.0473367635
10132,법조타운공영주차장,59,225,284,37.673315,127.046582
10133,도봉구청,755,458,1213,37.6689552465,127.0463337031
10134,도봉구청,581,641,1222,37.6688382917,127.0460153661
10135,방학1동대상타운현대삼성아파트,394,426,820,37.665833356,127.0464385387
10136,방학1동대상타운현대삼성아파트,164,134,298,37.6663876289,127.0460053525
10137,창동쌍용.성원아파트,313,712,1025,37.6604251641,127.0494952497
10138,창동쌍용아파트,907,317,1224,37.6604967889,127.04877913
10139,자운고등학교앞,365,437,802,37.658932863,127.0500065597
10140,자운고등학교앞,246,393,639,37.6586807038,127.0496686321
10141,창동동아청솔아파트,200,272,472,37.6566813833,127.0498048344
10142,창동동아청솔아파트,277,278,555,37.656671335,127.0495822895
10143,창동농협물류센터,756,174,930,37.6549321325,127.0503385996
10144,창동농협물류센터,402,925,1327,37.6542124806,127.0512466785
10145,창동농협물류센터,459,312,771,37.6538281446,127.0510007909
10146,창동역동측,700,345,1045,37.6535907021,127.0505902348
10147,창동동아아파트,126,275,401,37.651933,127.051465
10148,창동동아아파트,138,137,275,37.6513525023,127.0514438738
10149,창동주공19단지,273,111,384,37.6490406835,127.0523899949
10150,창동주공19단지,103,231,334,37.6492264659,127.0520286111
10151,창동주공18단지,279,49,328,37.6470625209,127.0530436187
10152,창동주공18단지,55,228,283,37.6472653853,127.0527729177
10153,도봉산입구,517,5,522,37.6870828083,127.0407179415
10154,도봉고등학교,433,15,448,37.6873184373,127.0441871881
10155,김근태기념도서관.도봉고등학교,10,740,750,37.6874938159,127.0440286782
10156,도봉역,216,69,285,37.6803220296,127.0466814888
10157,도봉역.도봉래미안아파트,93,322,415,37.6803959104,127.0470845566
10158,노원교,30,55,85,37.6794237641,127.0490169573
10159,노원교,32,144,176,37.6796543968,127.0491191453
10160,성대야구장노원교앞,196,270,466,37.67907,127.04939
10161,천주교도봉동교회,231,314,545,37.6712158708,127.0427070454
10162,천주교도봉동교회,356,271,627,37.6713119921,127.0428107756
10163,오봉초등학교,109,138,247,37.6705203068,127.0391794072
10164,나눔초등학교.오뚜기식품.두산벤처다임,687,955,1642,37.6707868238,127.0393403556
10165,방학2동공영주차장,248,99,347,37.6694362247,127.0366363352
10166,방학2동공영주차장,99,394,493,37.66956,127.03657
10167,방학2동주민센터,662,207,869,37.6682136969,127.0348108899
10168,오뚜기식품.두산벤처다임.나눔초등학교,1682,1167,2849,37.6682708426,127.0346224327
10170,인덕원역AK밸리.플러스아울렛,412,1057,1469,,
10172,신방학중학교앞,96,278,374,37.6637196179,127.0279943718
10173,방학동신우빌라,103,287,390,37.664078,127.03514
10174,평촌동행정복지센터.e편한세상아파트,1058,568,1626,37.6641158948,127.0348959433
10175,방학동삼익세라믹,96,301,397,37.661672,127.03493
10176,방학동삼익세라믹,224,103,327,37.6617551365,127.0346738125
10177,쌍문동청구아파트,276,484,760,37.6597398904,127.0350817617
10178,쌍문동청구아파트,200,110,310,37.6596243231,127.0348107133
10179,샘말어린이공원,409,1,410,37.6686672058,127.0318158985
10180,방학중학교정문,64,287,351,37.666488,127.034428
10181,방학중학교정문,451,145,596,37.6665470787,127.0341413947
10182,신한은행방학동지점,72,108,180,37.6634557599,127.0372935845
10183,신한은행방학동지점,73,86,159,37.6632312342,127.037197641
10184,연산군.정의공주묘,540,146,686,37.6617317184,127.02332141
10185,연산군정의공주묘,161,372,533,37.6620015247,127.0231445962
10186,방학동신동아타워,933,405,1338,37.6616802914,127.028111025
10187,방학동신동아타워,200,389,589,37.662028,127.028692
10188,방학3동신동아프라자,740,444,1184,37.6613704683,127.0274841055
10189,방학동신동아아파트,1298,306,1604,37.6619831294,127.0313834612
10190,방학동신동아아파트,295,786,1081,37.662362,127.03202
10191,방학초등학교,984,369,1353,37.6623619933,127.0342414798
10192,방학초등학교,290,1077,1367,37.662595,127.034113
10193,삼호아파트.평촌우리병원,1032,429,1461,37.6626546059,127.037002395
10194,신한은행방학동지점,267,887,1154,37.662933,127.036807
10195,비산체육공원,798,332,1130,37.6627158579,127.0406167927
10196,방학사거리,492,1153,1645,37.6629772212,127.0403874289
10197,서울문화고등학교,322,135,457,37.6628720833,127.046309519
10198,서울문화고등학교,454,190,644,37.662343449,127.047821244
10199,서울문화고등학교,149,463,612,37.6626297182,127.0480629127
10200,쌍문동청한빌라,845,74,919,37.6574593323,127.0150062055
10201,쌍문동청한빌라,34,488,522,37.657732,127.014762
10202,쌍문동우이빌라,154,82,236,37.6572501084,127.0190078891
10203,쌍문동우이빌라,18,225,243,37.6574304604,127.0180163153
10204,초당초등학교,1019,267,1286,37.6574025551,127.0230480688
10205,초당초등학교,225,638,863,37.657531,127.022295
10206,방학동우성아파트,565,109,674,37.6574046264,127.0242705926
10207,방학동우성.청구아파트,129,602,731,37.657656,127.0251
10208,방학3동신동아프라자,53,142,195,37.6608342669,127.0277400677
10209,방학3동주민센터,188,6,194,37.6598133715,127.0276286112
10210,쌍문동성원.금호타운2차아파트,661,196,857,37.6576477672,127.0289334878
10211,쌍문동성원아파트,339,568,907,37.6578472924,127.0287373024
10212,쌍문동한양.현대아파트,1324,237,1561,37.6578398426,127.0314515194
10213,쌍문동현대.한양아파트,393,1110,1503,37.6580003804,127.0313205806
10214,쌍문동삼익금호1차아파트,1470,521,1991,37.658048383,127.0347919771
10215,쌍문동금호1차삼익아파트,727,1611,2338,37.6582514168,127.0345433384
10216,도봉구보건소앞,568,434,1002,37.6572458182,127.0375306952
10217,도봉구보건소앞,553,1177,1730,37.6574389797,127.0375891737
10218,북서울교회,227,606,833,37.6572562221,127.0136533178
10219,서라벌중학교.우이동대우아파트,384,965,1349,37.655025,127.013223
10220,창동119안전센터,3,8,11,37.6463788339,127.0437915624
10221,덕성여대입구,645,1007,1652,37.65106,127.013138
10222,쌍문초등학교,244,266,510,37.6469743334,127.0256814814
10223,쌍문초등학교,376,245,621,37.647095,127.02539
10224,숭미초등학교,339,259,598,37.649556,127.027789
10225,숭미초등학교,318,303,621,37.6498332726,127.027819184
10226,둘리뮤지엄.대우이안극동아파트,171,552,723,37.6517710532,127.02842575
10227,둘리뮤지엄.대우이안극동아파트,581,377,958,37.6515270149,127.0282645929
10228,창동주공1단지,132,393,525,37.6542705499,127.0410046287
10229,창동주공1단지아파트,106,83,189,37.6536699078,127.0408838385
10231,서울북부지방법원등기국,99,223,322,37.651106,127.044525
10232,서울북부지방법원등기국,67,93,160,37.6514245604,127.0445412495
10234,창동역서측,1500,725,2225,37.652335845,127.0461227769
10235,창4동주민센터,30,67,97,37.6525121272,127.0523314066
10236,창4동주민센터,177,133,310,37.6527469996,127.0519925342
10241,창동주공4단지,452,403,855,37.6451010377,127.0482244126
10242,창동주공4단지,642,414,1056,37.6453057413,127.0480754907
10244,도봉문화정보도서관,43,182,225,37.6440866968,127.0443542991
10245,도봉문화정보도서관,70,345,415,37.6442125083,127.0440281367
10246,창림초교창동신창아파트앞,732,174,906,37.6415355739,127.0410384214
10247,창림초교창동신창아파트앞,331,753,1084,37.6416284932,127.0407268539
10248,국립현대미술관창동레지던시,1108,589,1697,37.6398501948,127.0394443113
10249,국립현대미술관창동레지던시,747,1012,1759,37.640398878,127.0395396001
10250,창동서울탁주앞,916,1505,2421,37.637707889,127.0373826795
10251,창동서울탁주앞,828,374,1202,37.6375883927,127.036931039
10252,창2동주민센터.보건지소,693,125,818,37.6408990489,127.0336397512
10253,창2동주민센터.보건지소,115,538,653,37.640778,127.033467
10256,창2동한일아파트,31,51,82,37.6461539659,127.0372571163
10257,창1동제1공영주차장입구,65,29,94,37.6463797917,127.037607982
10258,한신아파트101동앞,42,56,98,37.6459816934,127.0348523274
10259,KT도봉지점,31,84,115,37.6461924766,127.0351240039
10260,창동청구빌라,121,47,168,37.6458992987,127.0398002969
10261,창동청구빌라,100,242,342,37.6461243931,127.0395258217
10262,창림초등학교후문,348,256,604,37.643092,127.040517
10263,창림초등학교후문,36,114,150,37.6434101482,127.0403371755
10264,창동대우아파트,579,358,937,37.6426101856,127.0367159557
10265,창동역동측,2947,2384,5331,37.6539743778,127.0499897686
10266,창동역동측,906,506,1412,37.6536576919,127.0501720008
10269,서울가든아파트앞,18,33,51,37.6469310032,127.0442008606
10270,창1동주민센터,38,30,68,37.6487636037,127.0430117184
10271,창1동주민센터,58,36,94,37.6487341017,127.0427791548
10272,창동주공3단지,69,23,92,37.6509982018,127.0417180955
10273,창동주공3단지,30,58,88,37.6513229545,127.0414767297
10276,세그루학원,402,1412,1814,37.6565423713,127.0279900823
10277,세그루학원,1655,708,2363,37.6556242091,127.0278333324
10278,창동주공17단지,546,384,930,37.6457412104,127.0537656741
10279,창동주공17단지,266,398,664,37.6461055626,127.0536101559
10280,창3동염광아트빌,275,161,436,37.6344925058,127.042349857
10281,창3동염광아트빌,182,234,416,37.6344040379,127.0425216938
10282,한승미메이드아파트,152,72,224,37.6332317689,127.043671308
10283,한승미메이드아파트,142,232,374,37.6331768963,127.0435059071
10284,북서울농협창동지점,166,73,239,37.6341093323,127.0414905637
10285,북서울농협창동지점,116,232,348,37.6338519893,127.0412154818
10286,신화초교입구,208,39,247,37.6337044602,127.0402309119
10287,신화초교입구,112,277,389,37.6334072452,127.0400822024
10292,서울외국어고등학교,7,120,127,37.645154,127.052529
10293,서울외국어고등학교,141,3,144,37.6452469971,127.0527023636
10294,방학동도깨비시장입구,109,16,125,37.6652984161,127.0368156452
10295,거성학마을아파트,85,41,126,37.6663430678,127.0383406047
10296,도봉새마을금고본점,66,97,163,37.667145875,127.0412481803
10297,창5동현대아파트,149,137,286,37.6556229537,127.040400444
10298,창5동현대1차아파트,191,383,574,37.65587,127.040602
10299,창동아이파크,461,239,700,37.6616031259,127.0467532395
10301,창번교,68,22,90,37.6354839138,127.0384278157
10302,방학3동주민센터,436,640,1076,37.6591681347,127.0279037943
10303,도봉동서광아파트,89,72,161,37.6781990171,127.0494617013
10304,정병원,204,144,348,37.661947,127.04192
10305,창동고등학교.창북중학교,223,153,376,37.6513664604,127.0384575543
10306,정의여중고입구,236,186,422,37.6510121866,127.0331370812
10309,도깨비시장,265,559,824,37.665505,127.035503
10310,방학동도깨비시장,474,172,646,37.6654565426,127.0353281335
10311,태영데시앙아파트,288,242,530,37.642384365,127.0324449266
10312,창번교앞,53,158,211,37.6354686365,127.03822395
10313,금용아파트,108,39,147,37.637736706,127.0351770744
10314,창번2교앞,52,196,248,37.63859,127.034453
10315,대우아파트104동,902,752,1654,37.6432566421,127.038349191
10317,도봉산입구,1,311,312,37.6872224695,127.0406896745
10320,샘말어린이공원,3,249,252,37.668748,127.031945
10321,안방학동,289,216,505,37.6690677721,127.0299513375
10325,동아운수앞,78,519,597,37.658907,127.013997
10330,창동.신창시장,1232,1202,2434,37.6388467098,127.0384760994
10331,신창.창동시장,1030,752,1782,37.6392573593,127.0384574781
10333,안방학동,266,7,273,37.6676173155,127.0330084504
10334,안방학동,5,313,318,37.6678876413,127.0328952262
10335,창동농협물류센터,183,1020,1203,37.6548140039,127.0500740655
10336,태영데시앙아파트,123,364,487,37.6426266528,127.0317878535
10337,방학중학교,107,349,456,37.6667335659,127.032370012
10339,도봉산역광역환승센터,2,228,230,37.6898762161,127.0444996062
10340,도봉산역광역환승센터,496,5,501,37.6899483575,127.0443522431
10341,도봉산역광역환승센터,2,450,452,37.690177,127.044267
10342,한국사회봉사회,159,42,201,37.6618138354,127.0147587067
10343,한국사회봉사회,13,217,230,37.6621633293,127.0146769048
10411,창동교,20,21,41,37.6517301155,127.0532459112
10412,창동교,0,61,61,37.6521106678,127.0534954867
10413,녹천교,41,28,69,37.6447333973,127.0545213045
10414,녹천교,10,63,73,37.6450286435,127.0549455285
10501,창동역동측,1485,1037,2522,37.653604,127.049906
10502,도봉여성센터,294,144,438,37.6628827003,127.0302537587
10503,한일병원,709,681,1390,37.645868972,127.0284574972
10504,동익아파트,541,285,826,37.6506949897,127.0252305774
10505,꽃동네,413,464,877,37.6527572122,127.022498822
10509,한일병원입구,517,21,538,37.6445614593,127.0286428437
10510,용호약국,42,0,42,37.6499633172,127.025211064
10511,에덴약국,193,1,194,37.6514369621,127.0233665374
10512,청한빌라,284,7,291,37.6572646786,127.0151682419
10513,신창교,13,87,100,37.633019,127.039682
10514,신화초교.초안아파트,347,104,451,37.631585,127.041467
10515,사거리슈퍼,21,1,22,37.6497379178,127.0258093606
10516,쌍문1동현대아파트,125,2,127,37.6505864786,127.0226715612
10517,우이성당,296,13,309,37.6556918915,127.0157323897
10519,방학신동아1단지.방학3동주민센터,818,458,1276,37.658726,127.027717
10521,믿음주유소,52,1,53,37.6493746259,127.0265163993
10522,오복슈퍼,23,28,51,37.6495384245,127.0231778182
10526,쌍문1동주민센터,83,69,152,37.6482095603,127.0263788608
10527,코오롱아파트.덕성여대기숙사,591,105,696,37.6489176294,127.0229271728
10528,덕성여대후문.효문중고교앞,368,57,425,37.6526914381,127.0171019004
10529,창동아이파크,82,168,250,37.6612378102,127.0478602057
10531,도봉구보건소앞,267,649,916,37.6573821506,127.0377806894
10532,쌍문초등학교,406,119,525,37.6476490168,127.025011037
10533,쌍문1치안센터,390,49,439,37.6500958249,127.0202835758
10535,신일라이프아파트,126,57,183,37.6506912973,127.0294951701
10536,시립도봉노인종합복지관,141,593,734,37.6581010105,127.0355267033
10537,경기푸른미래관,463,54,517,37.6495484449,127.0219691394
10540,방학삼성래미안1단지아파트,40,175,215,37.6673955059,127.0462737888
10541,소피아호텔,85,311,396,37.651121436,127.0349113945
10542,쌍문동현대1차아파트,107,543,650,37.6580622671,127.0323860104
10546,미래빌라,56,107,163,37.6479708013,127.0264643918
10549,도봉중학교.서원아파트,15,39,54,37.6712739361,127.0457717409
10550,창동한신아파트,30,84,114,37.6459961514,127.0347140807
10551,성원아파트,23,288,311,37.6579159925,127.0301168678
10553,세무서앞,3,62,65,37.6532890093,127.0509355099
10556,창동중앙약국,27,103,130,37.6461540013,127.0371449268
10557,선덕사거리.세그루학원입구,93,284,377,37.657803811,127.028285241
10560,서울북부지방검찰청.한양수자인아파트,45,161,206,37.6746865772,127.0473813687
10561,오봉초등학교,21,31,52,37.6710237818,127.0398564343
10563,방학3동주민센터,19,134,153,37.6584636075,127.0274082286
10564,청구아파트,81,260,341,37.6577150088,127.0265443002
10565,엘지전자,16,34,50,37.6508502983,127.0313946417
10568,시온슈퍼,7,21,28,37.6728138601,127.0409094029
10569,창성빌라,89,245,334,37.6441949149,127.040308972
10570,김수영문학관,331,307,638,37.6594246503,127.0251961284
10572,서울북부지방법원,15,77,92,37.677670178,127.0492414111
10573,부부슈퍼,1,15,16,37.6744514399,127.0425393678
10575,벽산아파트,177,92,269,37.6583226778,127.0249781408
10578,삼거리슈퍼,5,21,26,37.675670191,127.0436465315
10580,방학3동주민센터,45,4,49,37.6582856906,127.0268961094
10582,믿음주유소,1,198,199,37.6493926166,127.0266535322
10583,쌍문초등학교,238,530,768,37.6478292345,127.0249119482
10584,창동고등학교.창북중학교,59,70,129,37.6512502397,127.0379917772
10585,도봉역,50,65,115,37.6809875292,127.0457799763
10586,성황당,30,32,62,37.6771875559,127.0437721274
10587,창2동주민센터.보건지소,345,151,496,37.6422156092,127.0356230477
10588,금호타운,709,80,789,37.6576773905,127.0293879937
10590,사거리슈퍼앞,1,129,130,37.6497982681,127.0259102437
10592,대우.삼성서비스센터,53,129,182,37.6831304492,127.0471188426
10593,도봉1동주민센터.럭키아파트,2,44,46,37.678620287,127.0437151494
10594,창2동건영아파트,313,73,386,37.6407674519,127.0337768025
10597,용호약국,39,146,185,37.6500858758,127.0251555744
10598,오복슈퍼,1,84,85,37.6496014864,127.0232469679
10599,도봉경찰서.창4동주민센터,49,161,210,37.6523110123,127.0516851003
10600,유원극동아파트,65,152,217,37.682771,127.048895
10604,북서울중학교,3,29,32,37.6795203048,127.0436413702
10612,쌍문동한양아파트,469,126,595,37.657868485,127.0325684045
10637,쌍문1동현대아파트,3,195,198,37.6505188837,127.0227440715
10638,한신아파트후문,60,170,230,37.6838280147,127.0495039881
10657,창동고등학교.창북중학교,106,207,313,37.6515935012,127.0381460822
10667,윤성빌라.다리앞,1,29,30,37.6790145516,127.0423594433
10697,에덴약국,3,147,150,37.6513747708,127.0234515159
10698,도봉파크빌2단지,7,19,26,37.6842317103,127.0515734531
10700,녹천역북부역,129,464,593,37.6456721729,127.0505872975
10701,창1동대우그린아파트,128,49,177,37.6469959833,127.0486325542
10702,창일중학교,213,170,383,37.6486610411,127.047867374
10703,창동역서측,1544,1061,2605,37.6523291893,127.0463383955
10704,상아아파트,50,78,128,37.6530582958,127.0432189107
10705,옛고을길입구,44,74,118,37.6508570874,127.0315854369
10706,창일중학교,81,136,217,37.6491535465,127.0473969976
10707,주공4단지후문,12,153,165,37.646858824,127.0483171871
10710,창동아이파크,62,264,326,37.660954256,127.0471636659
10711,북한산아이파크,97,276,373,37.6591925682,127.0419096759
10713,북한산아이파크,426,81,507,37.6590798301,127.0421159066
10714,창동아이파크,67,85,152,37.66103779,127.0474980379
10722,도봉초등학교,0,13,13,37.6784717098,127.0407189028
10726,도봉구보건소앞,509,286,795,37.6571578082,127.0376989713
10734,경기푸른미래관,86,361,447,37.6496562587,127.0220348239
10735,서원아파트,250,234,484,37.6716952848,127.0466777586
10736,창동이마트,220,39,259,37.6513329248,127.0461708888
10737,누원고등학교.한신아파트정문,4,52,56,37.6858016495,127.0509577365
10740,서울문화고등학교,110,319,429,37.6636468356,127.0467520626
10744,부대앞,0,31,31,37.6781182487,127.0389713981
10745,소피아호텔,213,180,393,37.6513619627,127.0351189022
10747,청구아파트,210,153,363,37.6575159,127.0264127549
10754,쌍문1치안센터,38,265,303,37.6501841,127.0204615261
10757,무수골,85,52,137,37.6777532993,127.0361868209
10775,정의여중고,131,198,329,37.6512012464,127.0331242114
10777,덕성여대후문.효문중고교앞,102,335,437,37.6527716123,127.0172526514
10778,부대앞,21,0,21,37.6780200195,127.0390076255
10779,신일라이프아파트,33,261,294,37.6509462068,127.0298771931
10780,약초원.동아슈퍼,12,312,324,37.6545604185,127.0160925096
10781,도봉초등학교,4,0,4,37.6783177932,127.0404396652
10783,우이1교,82,139,221,37.6439330888,127.0317544179
10784,우이성당,13,254,267,37.6560328264,127.0157596144
10785,엘지전자,27,63,90,37.6510629639,127.0313539323
10786,한신아파트정문,17,32,49,37.6864731679,127.0504502354
10787,윤성빌라.다리앞,21,0,21,37.6789379513,127.0423843417
10789,한일병원입구,3,341,344,37.6444216622,127.0291719949
10790,청한빌라,6,199,205,37.6573106168,127.0152985919
10791,도봉파크빌3단지,2,110,112,37.6879883235,127.0493865639
10792,북서울중학교,31,4,35,37.6795575228,127.0433971197
10797,도봉1동주민센터.럭키아파트,53,19,72,37.6786374607,127.0435711769
10798,신동아아파트16동,10,220,230,37.6601962887,127.027803303
10799,도봉산역,870,735,1605,37.6893500743,127.0466117182
10800,성황당,24,22,46,37.6769488243,127.0436280078
10802,도봉파크빌3단지,5,11,16,37.6879397664,127.0491450189
10803,삼거리슈퍼,14,1,15,37.6755926524,127.0434480274
10804,대원그린아파트.도봉실버센터,0,98,98,37.6625589484,127.0276624996
10805,부부슈퍼,10,2,12,37.674596518,127.0425258468
10806,방학동극동아파트.방학동천주교성당,269,233,502,37.6636518246,127.0282160499
10807,시온슈퍼,22,11,33,37.6731273774,127.0410739524
10808,방학중학교,363,56,419,37.6666528006,127.0325922954
10809,오봉초등학교,34,19,53,37.6710355447,127.0397113391
10810,누원고등학교.한신아파트정문,156,40,196,37.6856747197,127.0506753264
10812,도봉파크빌2단지앞,105,52,157,37.6841482332,127.0513389756
10813,도봉중학교.서원아파트,105,141,246,37.6705522883,127.0463167964
10814,극동유원아파트후문,98,18,116,37.6820001335,127.050685298
10816,삼환아파트후문,7,22,29,37.6802200817,127.0495741502
10818,삼환.동아에코빌아파트,173,38,211,37.6805570067,127.0475733049
10819,대상타운현대아파트,248,115,363,37.6657951567,127.046203333
10821,서울문화고등학교,157,121,278,37.6639683106,127.0464770451
10822,서울북부지방법원,42,17,59,37.6769856293,127.0485936182
10826,서울북부지방검찰청.한양수자인아파트,129,42,171,37.6747299568,127.0470617037
10828,하나약국,55,60,115,37.6724630827,127.046473053
10831,한신아파트정문,0,74,74,37.6866129511,127.0500737384
10834,약초원.동아슈퍼,298,30,328,37.6542863205,127.0160182342
10836,코오롱아파트.덕성여대기숙사,101,389,490,37.6488535848,127.0232739332
10838,법종사,3,16,19,37.6572458455,127.0183105701
10841,효문중학교,11,119,130,37.6515334353,127.0186268132
10842,효문중학교,69,42,111,37.6514951821,127.0183803349
10843,도봉중학교후문,9,25,34,37.6711168303,127.0450448623
11101,공릉시장,559,395,954,37.6227408373,127.0741781792
11102,공릉시장,554,500,1054,37.6231160369,127.0736211764
11103,태릉입구역4번출구,566,540,1106,37.6195890997,127.0752002532
11104,태릉입구역3번출구,441,378,819,37.6194253308,127.0748409839
11105,태릉입구역,424,696,1120,37.6174050827,127.0743733189
11106,태릉입구역,239,322,561,37.6170160254,127.0745338498
11107,공릉1동삼익아파트,83,78,161,37.6179507657,127.0727577135
11108,공릉초등학교,29,91,120,37.6186521132,127.0735465403
11109,대주아파트,69,77,146,37.6213166942,127.0719631752
11110,공릉행복발전소,41,59,100,37.6221490333,127.0723921996
11111,공릉대아2차아파트,34,57,91,37.6229904068,127.0713043223
11112,서울창업디딤터,624,223,847,37.6197132662,127.0781312929
11113,경춘선숲길.토끼굴앞,35,221,256,37.6192099264,127.0796853957
11114,주유소앞다운복지관,360,247,607,37.6189463149,127.0797927204
11115,서울창업디딤터,187,662,849,37.6188796917,127.0783739499
11116,서울생활사박물관.농협앞,146,398,544,37.6186839765,127.0779971246
11117,태릉입구역7번출구.서울생활사박물관,1103,199,1302,37.6178559331,127.0766766891
11118,화랑대역1번출구,1560,218,1778,37.6197810079,127.0832854305
11119,공연초등학교,49,318,367,37.6268143537,127.0761279796
11120,공릉역,1053,263,1316,37.6259822146,127.0741277355
11121,서울과학기술대앞,432,269,701,37.6303484607,127.0761457452
11122,동신아파트,431,114,545,37.6276288051,127.0775731645
11123,현대성우아파트,19,148,167,37.6274687926,127.0777061051
11124,동부아파트,465,366,831,37.6273894182,127.0785188231
11125,한보아파트.삼익아파트,379,6,385,37.6275466907,127.0804798611
11126,삼익아파트.한보아파트,10,329,339,37.6273433068,127.0800990621
11127,원자력병원,693,746,1439,37.628407354,127.0820911679
11128,원자력병원입구,769,475,1244,37.6262715664,127.0794578764
11129,안마을,370,639,1009,37.6234578543,127.0795189611
11130,두산힐스빌아파트,181,305,486,37.6213870578,127.0788883617
11131,두산힐스빌아파트,230,365,595,37.6213409964,127.079046912
11132,안마을,590,335,925,37.6236970732,127.0794300566
11133,공릉해링턴플레이스,164,113,277,37.6282670614,127.0850407835
11134,원자력병원.공릉해링턴플레이스,284,521,805,37.6271440983,127.0853188634
11135,공릉우방아파트,492,683,1175,37.626095,127.086035
11136,태릉해링턴플레이스아파트,647,590,1237,37.625334513,127.0859251214
11137,화랑타운아파트,132,387,519,37.623608,127.086747
11138,청솔아파트,167,495,662,37.623300094,127.0865288069
11139,화랑대역2번출구,425,1629,2054,37.6202214222,127.083590654
11140,화랑대사거리,146,234,380,37.6218122867,127.088121412
11141,화랑대사거리,210,691,901,37.6219733458,127.0878830552
11142,경춘선숲길.화랑대철도공원,53,289,342,37.623843981,127.0911284809
11143,경춘선숲길.화랑대철도공원,472,97,569,37.6235352001,127.0902613846
11144,서울여대.육군사관학교행정안내소,79,303,382,37.6259021468,127.0947361313
11145,서울여대.육군사관학교행정안내소,553,86,639,37.6261675083,127.0945526831
11146,태릉국제사격장,0,13,13,37.6276474938,127.0962777688
11147,태릉국제사격장,11,19,30,37.6281945254,127.0961867051
11148,태릉,3,10,13,37.6301893532,127.0985753415
11149,태릉,13,21,34,37.63046,127.098258
11150,태릉선수촌,0,12,12,37.633302178,127.1032736039
11151,태릉선수촌,11,2,13,37.6338984084,127.1035996118
11152,태릉국제스케이트장,3,82,85,37.6355918609,127.1062793991
11153,태릉국제스케이트장,14,1,15,37.6351530701,127.1053040519
11154,삼육대앞,119,193,312,37.6384153875,127.1084328965
11155,삼육대앞,295,49,344,37.638787998,127.1083937637
11156,담터고개,40,50,90,37.6408998623,127.1111217141
11157,원자력병원공릉동삼익2차아파트,343,592,935,37.6260432496,127.0797928224
11158,예수사랑교회,733,287,1020,37.6223048363,127.0871773715
11159,서울과학기술대입구,470,380,850,37.6284740985,127.071801265
11160,서울과학기술대입구,576,480,1056,37.6283444968,127.0713744537
11161,공릉역1번출구,401,502,903,37.626690375,127.0727039269
11162,공릉역4번출구,400,462,862,37.6266095264,127.0723130282
11163,공릉신도2차아파트,44,108,152,37.6253915545,127.0713064945
11164,공릉대동2차아파트,59,80,139,37.6268706243,127.0710519858
11165,공릉대동2차아파트,88,88,176,37.6271292281,127.0707517862
11166,노원문화원,72,30,102,37.6283778949,127.0699476545
11167,노원문화원,54,149,203,37.6286113424,127.0698345772
11168,용원초등학교,266,230,496,37.6286591696,127.0687125746
11169,용원초등학교,231,80,311,37.628269518,127.0686697345
11170,공릉동.동신아파트앞,323,378,701,37.6282300863,127.0775443672
11171,공릉2단지,219,92,311,37.6306397464,127.0675701967
11172,서울과학기술대학교후문,133,261,394,37.6311208645,127.0831052478
11173,영화교회,14,24,38,37.6305719879,127.0716994523
11174,서울과학기술대학교후문,58,175,233,37.632515003,127.0832993935
11175,공릉삼익아파트,20,53,73,37.6294796422,127.0733714013
11176,공연초등학교,149,210,359,37.6267236629,127.0755405228
11177,공릉역,238,792,1030,37.6259895946,127.0736172131
11178,공릉1단지후문,48,36,84,37.631316499,127.0697006293
11180,상계주공9단지,183,380,563,37.6629604016,127.0584559747
11181,부천시민회관,175,250,425,37.6613205166,127.0545329249
11182,임광아파트상가,82,266,348,37.661178,127.057463
11183,상계주공7단지,213,375,588,37.6603667717,127.0591136049
11184,대림아파트상가,903,629,1532,37.6603435605,127.0586794778
11185,도봉면허시험장,1501,1053,2554,37.6574468479,127.0599658724
11186,도봉면허시험장,917,1405,2322,37.6573380333,127.0595396275
11187,상계주공7단지,19,27,46,37.6609052625,127.0598156383
11188,상계주공7단지.광림교회앞,105,178,283,37.6605619018,127.0626050014
11189,상계10동우체국,252,126,378,37.6607333963,127.0628214067
11190,청원고등학교,309,337,646,37.6650492388,127.0617198674
11191,상계주공9단지,1095,132,1227,37.6645767657,127.058796161
11192,온곡중학교.노원중앙도서관,30,98,128,37.6595872028,127.0645319222
11193,온곡중학교.노원중앙도서관,72,22,94,37.6592927621,127.064476727
11194,두산아파트.도심공항수락터미널,313,123,436,37.6787167696,127.0531830061
11195,두산아파트.도심공항수락터미널,90,414,504,37.6785004733,127.0533188837
11196,수락산역3번출구,1799,1207,3006,37.6771708775,127.0555614524
11197,수락산역,588,1042,1630,37.6773540117,127.0551013061
11198,노일초등학교,1054,424,1478,37.6735135543,127.0552560424
11199,노원초등학교,578,921,1499,37.6729155315,127.055749111
11200,상계현대2차아파트,610,336,946,37.6717178437,127.0509549057
11201,상계현대3차아파트,46,277,323,37.6709521187,127.0525754362
11202,수락리버시티아파트,88,32,120,37.6893310475,127.0552031453
11203,수락리버시티아파트,29,54,83,37.6890118581,127.0556485232
11204,수락중고등학교,381,143,524,37.6828387764,127.0552708957
11205,수락중고등학교,70,304,374,37.6829300008,127.0555582132
11206,은빛아파트2단지,414,293,707,37.6802094382,127.0552746136
11207,홍파복지원.수락산벨리체아파트,198,303,501,37.6802608778,127.0555052094
11208,상계초등학교,216,584,800,37.6576160971,127.0659938755
11209,상계초등학교,200,283,483,37.6581049302,127.065903645
11210,노원역9번출구,2283,2146,4429,37.6560911065,127.0619864543
11211,노원역1번출구,4323,1814,6137,37.656202,127.063365
11212,롯데백화점노원점.노원역4번출구,980,994,1974,37.6548295813,127.0622715487
11213,와우패션클럽,358,2044,2402,37.655191203,127.0638662325
11214,중앙하이츠2차아파트,462,587,1049,37.654692,127.067488
11215,상계중학교정문,370,248,618,37.6525896504,127.0681368524
11216,상계중학교,58,64,122,37.6515820512,127.0694249362
11217,코오롱아파트.양지대림아파트,267,314,581,37.652497575,127.0707159998
11218,상계119안전센터,342,194,536,37.6540787526,127.0715548974
11219,상계119안전센터,270,240,510,37.6542272425,127.0718383476
11220,상계동주유소,281,156,437,37.6575214427,127.0716240844
11221,상계동주유소,78,260,338,37.6577519815,127.0718498531
11222,부천전화국,288,408,696,37.658467,127.070695
11223,상계중앙시장입구,339,218,557,37.6586382774,127.070632802
11224,흥안운수종점,0,381,381,37.6697664795,127.0809233223
11225,흥안운수종점,387,3,390,37.6696689099,127.0805894157
11226,불암현대아파트,162,16,178,37.6682034017,127.0793552115
11227,동아불암아파트,782,52,834,37.6661480625,127.0777874472
11228,동아불암아파트,27,754,781,37.6670483264,127.0787107626
11229,노원롯데캐슬시그니처아파트,48,866,914,37.6648599952,127.0771188688
11230,노원롯데캐슬시그니처아파트,644,30,674,37.6649502043,127.0769489531
11231,부천전화국,131,760,891,37.6631758119,127.0761169302
11232,흥안운수상계4동종점,2,330,332,37.6709176644,127.0825488607
11233,상계역사거리,86,468,554,37.6597433281,127.0721269911
11234,상신교회,139,473,612,37.661312,127.070768
11235,상신교회,243,138,381,37.661425,127.070903
11236,계상초등학교,252,268,520,37.6628310717,127.0689792332
11237,상계5동주민센터,374,309,683,37.6628644876,127.0691876995
11238,상계한신2차아파트,402,452,854,37.664199,127.066944
11239,상계한신2차아파트,754,727,1481,37.6644437316,127.0666569148
11240,상계역5번출구.상계벽산아파트,824,539,1363,37.661292174,127.0734913289
11241,당고개입구오거리,335,257,592,37.6629352854,127.0753601646
11242,상계2동주민센터,198,268,466,37.657570036,127.0677787534
11243,벽산아파트103동,443,274,717,37.6605656133,127.0718982879
11244,노원역6번출구.상계주공3단지,2212,1210,3422,37.6519422405,127.0610352252
11245,상계주공2단지,1062,778,1840,37.6493744118,127.0617372427
11246,상계주공1단지,1148,511,1659,37.6473083568,127.062780841
11247,마들근린공원.노원에코센터,269,527,796,37.6450508428,127.0594958083
11248,마들근린공원.노원에코센터,450,215,665,37.6452860969,127.0595368052
11250,노원구청,1502,661,2163,37.6539307032,127.0581486869
11251,노원구청,640,848,1488,37.6542764042,127.0572410143
11252,노원구청,1089,1289,2378,37.6543087235,127.0574869763
11253,상계주공2단지223동,86,45,131,37.6479063362,127.056992054
11254,상계주공2단지,9,33,42,37.6511093271,127.0604208967
11255,노원역5번출구.상계주공6단지,853,1494,2347,37.65318414,127.0611445117
11256,상계주공4단지,808,1181,1989,37.6507752318,127.0617647168
11257,백병원.한국성서대학교,1048,1303,2351,37.6480182386,127.06288209
11260,상계6.7동주민센터,310,351,661,37.6544207283,127.06720443
11261,상계중학교,151,410,561,37.6523542041,127.0678156944
11262,상계2동주민센터,119,348,467,37.6576377753,127.0674898279
11266,상경초등학교,322,73,395,37.6707971529,127.0520711414
11267,상계주공15단지,720,489,1209,37.6682902974,127.0565591686
11268,마들역,524,363,887,37.665283,127.05742
11269,상계주공10단지,492,313,805,37.6621441437,127.0582161724
11270,노원고등학교,149,94,243,37.6616899164,127.0544628693
11271,상계주공10단지상가,389,240,629,37.6614240662,127.0576004621
11272,상계주공14단지,158,533,691,37.669103,127.056828
11273,마들역,879,893,1772,37.666492,127.057562
11274,보람아파트1단지,156,884,1040,37.6644083632,127.0654519677
11275,보람아파트2단지,612,103,715,37.6647816002,127.0643815398
11276,청원고등학교,225,395,620,37.6652295093,127.0616145996
11277,상계주공12단지1202동,128,811,939,37.6649222801,127.0597893905
11278,국민은행.부천북부역,668,1771,2439,37.622578,127.061673
11279,광운대역,867,288,1155,37.6226060942,127.0618283741
11280,월계현대아파트,233,246,479,37.6198348679,127.0633583399
11281,월계현대아파트,423,329,752,37.6193189084,127.063400106
11282,월계1동경로당,382,153,535,37.617162878,127.0641713213
11283,석계역1번출구A,3577,2575,6152,37.61493,127.065197
11284,석계역2번출구,253,1673,1926,37.615274256,127.0669732146
11285,광운대학교,579,391,970,37.6199611496,127.0584818555
11286,월계삼거리,389,586,975,37.6226677969,127.0600070288
11287,부천북부역농협,419,127,546,,
11291,청백아파트1단지,514,183,697,37.635412,127.052187
11292,대우아파트,411,7,418,37.6331096709,127.0521635327
11293,청백아파트3단지4단지,725,9,734,37.6317357344,127.0509346985
11294,청백아파트3단지4단지,3,736,739,37.6316287727,127.051063481
11295,초안아파트.흥화브라운빌아파트,276,196,472,37.632069829,127.0443046725
11296,초안아파트.흥화브라운빌아파트,234,190,424,37.6322996705,127.0440640682
11297,쌍용스윗닷홈아파트,68,83,151,37.6303980739,127.0454252205
11298,신창중학교후문,97,36,133,37.6279668876,127.0473977009
11299,온세미,154,171,325,37.6279194677,127.0472744107
11300,온세미,742,461,1203,37.6275401275,127.0503112065
11301,염광고등학교,606,616,1222,37.627301235,127.0502378296
11302,월계주공1단지상가,550,267,817,37.6266902177,127.051625114
11303,월계공단,385,411,796,37.6271301634,127.0518546625
11304,공구상가,47,290,337,37.6274894153,127.052594232
11305,공구상가,187,130,317,37.6274848307,127.0527726487
11306,월계주공2단지,287,668,955,37.6283500757,127.0538076332
11307,월계주공1단지,686,161,847,37.6282861056,127.0541042987
11308,원미구청,226,303,529,37.6286565922,127.0551761985
11309,인덕대학교,107,464,571,37.6286706713,127.0554101788
11310,월계주공108동앞롯데캐슬루나아파트,879,651,1530,37.6261891646,127.0525926058
11311,인덕대학교,479,685,1164,37.6279837976,127.0552744331
11312,한진한화그랑빌아파트,318,783,1101,37.6158054934,127.0692324274
11313,한진한화그랑빌아파트,178,77,255,37.6182551734,127.0698588736
11314,한천초등학교,233,125,358,37.6194526551,127.0698707848
11315,한천초등학교,176,300,476,37.619986091,127.0699692449
11317,월계미성아파트,105,332,437,37.6216829103,127.0693433176
11318,월계미륭아파트,297,141,438,37.6231065697,127.0683895402
11319,월계미륭아파트,165,270,435,37.6233839659,127.0686265665
11320,월계삼호아파트,241,57,298,37.6251751879,127.0672913812
11321,월계삼호아파트,48,239,287,37.6253210274,127.0675294239
11322,월계삼호4차아파트,271,54,325,37.6264654662,127.0658231365
11323,월계삼호4차아파트,42,205,247,37.6266627148,127.0659819208
11324,녹천초등학교월계이마트,10,72,82,37.628387,127.064038
11325,녹천초등학교월계이마트,27,22,49,37.6275517792,127.0649064093
11326,월계사슴아파트2단지,212,427,639,37.6321060914,127.0605903005
11327,월계사슴아파트3단지,128,33,161,37.6319573995,127.0604079103
11328,월계역,369,467,836,37.6339280991,127.0592762067
11329,월계역,246,91,337,37.6337353806,127.0590505789
11330,대우아파트,1,133,134,37.6338935455,127.0523147751
11331,인덕삼거리,527,606,1133,37.6284624555,127.0574774566
11332,신도브래뉴.한전노원변전소,177,139,316,37.6281868034,127.0591991542
11333,광운중.광운인공지능고등학교,302,164,466,37.6189553524,127.0563054062
11334,광운중.광운인공지능고등학교,176,345,521,37.6189484896,127.0565299947
11335,광운대학교,324,591,915,37.6198429291,127.0581457879
11336,월계삼거리,673,592,1265,37.6226139883,127.0596195164
11337,롯데캐슬루나아파트,609,484,1093,37.6252058932,127.0515079764
11338,인덕대앞,1352,740,2092,37.629037896,127.0575128243
11339,월계보건지소,775,859,1634,37.6319764625,127.0616208868
11340,월계보건지소,979,747,1726,37.631739905,127.0617141548
11341,교육촌.벼루말,27,231,258,37.621968564,127.0527149439
11343,장석교회,3,70,73,37.624206185,127.050612394
11344,쌍용스윗닷홈아파트,107,118,225,37.6306057989,127.0450262042
11345,인덕삼거리,76,225,301,37.6286993108,127.0571622955
11346,신도브래뉴.한전노원변전소,25,213,238,37.6284009858,127.0588028306
11347,상명고등학교.성원아파트,936,526,1462,37.6499131394,127.0691542558
11348,중계1동주민센터,991,2941,3932,37.6517260526,127.0769381389
11349,은행사거리,1179,772,1951,37.6488502006,127.0764225838
11350,양지근린공원,84,8,92,37.6467214594,127.0763720835
11351,서라벌고등학교,56,174,230,37.6448411567,127.0750013294
11352,불암중학교,205,331,536,37.6465290775,127.0742897898
11353,불암중학교,184,170,354,37.6465375422,127.0741270461
11354,중계주공10단지.중계건영3차아파트,1095,339,1434,37.6477075282,127.0736280814
11355,롯데우성아파트,616,939,1555,37.647506932,127.0738318466
11356,중계구민체육센터,198,806,1004,37.6476008953,127.0712087432
11357,중계구민체육센터,468,213,681,37.6477683703,127.0712792746
11358,롯데마트,360,287,647,37.6471915457,127.0702112033
11359,을지중학교,13,379,392,37.6505399939,127.0718008004
11360,을지중학교,114,24,138,37.6502087203,127.0709042219
11361,청암중.고등학교,55,276,331,37.6528902309,127.0739504972
11364,중계주공5단지514동,527,73,600,37.6508108548,127.0749325352
11365,원광초등학교,312,342,654,37.6544907121,127.076600728
11366,중계역,761,988,1749,37.6440707149,127.0643729214
11367,노원구민의전당,1002,1429,2431,37.6393911575,127.0664180981
11368,건영옴니백화점,152,131,283,37.6389014586,127.0641135366
11369,브라운스톤중계.우리은행앞,142,155,297,37.6394555843,127.0640918612
11370,서울아이티고등학교,10,42,52,37.6426301809,127.0624369874
11371,서울아이티고등학교,69,9,78,37.6416979423,127.063103394
11372,어린이교통공원,1172,165,1337,37.6453576799,127.0628698469
11373,중계역,732,648,1380,37.6432188922,127.0650888491
11374,서울시립북서울미술관,1259,721,1980,37.6397469276,127.0667400159
11375,중계건영2차아파트,175,1452,1627,37.6460992901,127.0652453816
11376,중계역2번출구,1917,421,2338,37.6456175479,127.0649391251
11377,상명초등학교,275,400,675,37.6478506148,127.0677841912
11378,중계3단지목련아파트,253,418,671,37.6475000013,127.0679665353
11379,상명고등학교,448,692,1140,37.6494835403,127.0690664892
11380,목련아파트상가,573,507,1080,37.6468582175,127.0698765896
11381,중계목화아파트4단지,319,343,662,37.6435314138,127.0714066755
11382,용동초등학교,45,174,219,37.6421162703,127.069131057
11383,용동초등학교,182,28,210,37.6418721472,127.0690118488
11384,2001아울렛중계점,45,87,132,37.6416882067,127.067663219
11385,2001아울렛중계점,74,34,108,37.6413078231,127.066846218
11386,홈플러스중계점,1,202,203,37.6407225926,127.0686266493
11387,노원평생학습관,16,0,16,37.6393428578,127.0689347229
11388,대진여자고등학교,65,7,72,37.6445489348,127.0671607204
11389,청계초등학교,6,59,65,37.6445081062,127.0669303287
11390,중계역1번출구,329,1315,1644,37.6462649447,127.0637572701
11391,상계역5번출구,1053,553,1606,37.6613639532,127.0739702355
11392,상계역3번출구,2976,753,3729,37.6593,127.073033
11393,상계역3번출구,608,3359,3967,37.659431118,127.0732121987
11394,중계주공3단지,437,535,972,37.6569539508,127.0770171958
11395,중계주공2단지,816,894,1710,37.6570502707,127.0778332524
11396,중계주공4단지,93,498,591,37.655012,127.07801
11397,중계주공4단지,194,205,399,37.6541374992,127.0783571637
11398,중계1동주민센터,1927,224,2151,37.651867022,127.0775628848
11399,신한은행중계동지점,466,658,1124,37.6505432096,127.0774015203
11400,기업은행중계동WM센터,488,69,557,37.6507367718,127.0776283567
11401,공릉신도2차아파트,89,67,156,37.6254122748,127.0715005195
11402,노원문화예술회관.불암초등학교,439,21,460,37.6506776631,127.0801602952
11403,노원문화예술회관.불암초등학교,838,1353,2191,37.6500481925,127.0809177871
11404,영신여자고등학교입구,386,8,394,37.6498199266,127.081117547
11405,불암고등학교,318,353,671,37.6485021744,127.0805749976
11406,중계본동주민센터,775,21,796,37.6474739679,127.0806838117
11407,노원우체국,163,972,1135,37.6460324291,127.0817180202
11408,노원우체국,1122,8,1130,37.6461584467,127.0819108069
11409,중계본동종점,196,3,199,37.644643,127.083058
11410,중계주공7단지,7,613,620,37.647938,127.079788
11411,중계주공6단지상가,554,68,622,37.6481262911,127.0794424677
11412,대림벽산아파트,12,386,398,37.647837,127.077428
11413,중계주공6단지,416,66,482,37.6480879151,127.0775774413
11414,은행사거리,1561,2094,3655,37.6498880968,127.076862587
11415,대림벽산아파트,1,176,177,37.646757256,127.0767460489
11416,하계역,1272,1031,2303,37.6373880054,127.0677830754
11417,하계미성아파트,457,795,1252,37.6350943944,127.0688261293
11418,서울과학기술대앞,246,546,792,37.6305565211,127.0760825727
11419,중계주공9단지후문,11,121,132,37.6430227729,127.0766005742
11420,중계주공9단지후문,32,24,56,37.6430297743,127.0762238387
11421,삼익선경아파트후문.시립과학관,46,52,98,37.6399032712,127.0763594384
11422,한신동성아파트.시립과학관,72,55,127,37.640196263,127.0760934791
11423,삼익선경아파트,169,362,531,37.6381084499,127.0775270502
11424,대진고등학교.하계우방아파트,375,172,547,37.6378760581,127.0773942359
11425,하계미성아파트.을지병원,2591,757,3348,37.6365847976,127.0694328255
11426,하계역2번출구,1204,2102,3306,37.6368537465,127.0694876352
11428,한성여객종점,212,19,231,37.63813,127.070056
11429,한성여객종점,122,277,399,37.6372710586,127.070816008
11431,북부여성발전센터앞,28,5,33,37.6432608103,127.062362481
11432,그린아파트101동앞,12,13,25,37.6443053969,127.0619180071
11433,대진고등학교,191,662,853,37.6379362241,127.0736490566
11434,골마을근린공원,851,664,1515,37.6383459245,127.0742334891
11435,서울온천,531,1037,1568,37.6393648263,127.0743080173
11436,하계1동주민센터,538,375,913,37.6404263202,127.0728303267
11437,노원경찰서.혜성여고,576,649,1225,37.6420899031,127.0725259962
11438,노원경찰서,1029,467,1496,37.6420164888,127.072129677
11439,동천학교,294,183,477,37.6440829404,127.0742363652
11440,동천학교,178,210,388,37.6440742238,127.0737689624
11441,서라벌고등학교,90,231,321,37.6450151415,127.0747386856
11442,하계현대아파트,380,338,718,37.6449579802,127.0711485363
11443,홈플러스중계점,161,1,162,37.6404665818,127.0689922571
11444,하계한신청구아파트,0,17,17,37.6391915536,127.0689460415
11445,경기기계공업고등학교,190,261,451,37.6309290578,127.0740537568
11446,한천중학교,270,223,493,37.6309420546,127.0734430848
11447,하계역,1226,1039,2265,37.6368047138,127.067615433
11448,하계장미아파트,926,561,1487,37.634078815,127.0688040917
11449,하계2동주민센터,45,47,92,37.6319841413,127.0681378605
11450,하계2동주민센터,15,17,32,37.6317701688,127.0681178395
11451,중평초등학교,39,8,47,37.6365987516,127.0653719794
11452,하계극동아파트,502,430,932,37.6338331586,127.064587841
11453,하계시영아파트,362,1176,1538,37.6340534239,127.0654518866
11454,하계우성아파트,1857,433,2290,37.6351406925,127.0666509253
11455,하계장미아파트,866,2112,2978,37.6349277927,127.0669625244
11456,중평초등학교,52,39,91,37.6369593504,127.0650012481
11457,석계역1번출구,484,4,488,37.615298,127.064773
11458,중계1동신안아파트,368,13,381,37.6512469657,127.0722915838
11459,하계5단지아파트,61,55,116,37.633941468,127.0663248698
11460,그린아파트101동앞,2,40,42,37.644343387,127.0616415379
11461,북부여성발전센터앞,6,40,46,37.643175307,127.0621743013
11462,당현초등학교,19,52,71,37.6483442236,127.0589261989
11463,상계주공2단지상가,82,41,123,37.6504106403,127.0570694279
11464,월계미성아파트,338,112,450,37.6214670481,127.0691617763
11465,벼루말교,140,216,356,37.6198488394,127.055220831
11466,청구빌라.연촌초등학교,138,2,140,37.6350950706,127.0714772101
11467,청구빌라.연촌초등학교,2,75,77,37.63528,127.071537
11468,벼루말교,234,118,352,37.6196650162,127.0552252263
11469,하계1치안센터,2,72,74,37.6331123322,127.0724127941
11470,하계1치안센터,57,4,61,37.6329494935,127.0722633137
11474,월계중학교,2,290,292,37.6300545578,127.0511179201
11475,염광중학교후문,144,18,162,37.6303366157,127.0510739268
11476,월계1동경로당,156,631,787,37.6170537289,127.0640318343
11477,월계역신도브래뉴아파트앞,62,91,153,37.6298807194,127.0590758831
11478,구묵동교,71,294,365,37.6183307692,127.0786053295
11481,석계역1번출구B,2040,1630,3670,37.6149233568,127.0652029255
11482,삼화상운차고지,71,5,76,37.6260862831,127.0529460051
11485,월계동진아교통,0,492,492,37.627735,127.064418
11486,월계동진아교통,984,373,1357,37.627618,127.06447
11487,중계본동종점,13,58,71,37.644617,127.082796
11489,한성여객종점,64,8,72,37.6375349947,127.0706354793
11491,흥안운수상계4동종점,409,4,413,37.6708342206,127.0822757357
11493,삼화상운,322,172,494,37.627217,127.05038
11499,유원극동아파트,118,127,245,37.6296015672,127.0461279839
11500,유원극동아파트,130,105,235,37.6296727092,127.0462390596
11501,월계미륭아파트,8,34,42,37.6240374947,127.0680456484
11502,7단지영업소,170,24,194,37.6602778615,127.0637357104
11503,수락리버시티3.4단지,468,92,560,37.6872109624,127.0526873942
11504,7단지영업소,0,105,105,37.6596419854,127.0641070552
11505,경춘선숲길방문자센터,242,299,541,37.6318318995,127.0703978385
11506,월계주공1단지아파트앞,0,235,235,37.62626,127.05156
11507,불암산스포츠타운,6,33,39,37.6390159235,127.0828056335
11509,불암산스포츠타운,16,16,32,37.6386873571,127.0824367108
11511,수락현대아파트,180,16,196,37.6746356354,127.0602823906
11512,서울특별시북부기술교육원,172,147,319,37.6421605433,127.0571172663
11513,상계8동주민센터,604,447,1051,37.6669730538,127.051942026
11514,온곡초등학교,225,103,328,37.6667154619,127.0664537758
11515,상계역,2003,1589,3592,37.660644234,127.0736491547
11516,수락산디자인거리,39,15,54,37.6749732449,127.0578760501
11518,상계주공11단지,134,22,156,37.667017757,127.055119735
11519,보람아파트앞,34,1,35,37.6649666306,127.0661699718
11521,노원센트럴푸르지오아파트상가,26,91,117,37.6638676034,127.0751187662
11522,7호선수락산역,208,41,249,37.6758346525,127.0558589832
11524,마들역,143,188,331,37.666379,127.057202
11527,오뚜기슈퍼,10,36,46,37.664375249,127.0727573729
11530,상계주공9단지,219,15,234,37.6646710926,127.0593675238
11532,대동아파트,15,25,40,37.6201359781,127.0722416267
11534,또또슈퍼,11,75,86,37.6653067674,127.0716043605
11535,상계주공14단지,540,90,630,37.6709217102,127.0578625428
11537,청원고등학교,472,40,512,37.6645170181,127.0611130008
11538,수락산역,320,179,499,37.6778216107,127.0552228287
11539,대동택시,30,116,146,37.6658821177,127.0708375154
11540,14단지상가,201,26,227,37.6697567019,127.0595053381
11542,상계주공9단지.포레나노원,283,20,303,37.6622649228,127.0616937591
11545,상계금호어울림아파트입구,51,243,294,37.666592042,127.0695323546
11546,상원초등학교,213,64,277,37.6681065609,127.0603076176
11549,주유소앞,40,103,143,37.655617199,127.0658941981
11550,건민약국앞,51,76,127,37.6250138329,127.0719758027
11551,노일중학교,19,51,70,37.6725397529,127.0546941742
11552,한신1차아파트후문,31,92,123,37.6659065133,127.0692075262
11553,청원고등학교후문,228,111,339,37.6669955926,127.0616682026
11554,벽산상가,41,16,57,37.6355998817,127.0655683222
11556,롯데백화점.노원역4번출구,92,283,375,37.6547839375,127.0621375121
11558,상계1차현대아파트,69,83,152,37.6720621442,127.0528006763
11559,상계한신1차아파트상가,5,53,58,37.6652660143,127.0689224185
11560,상계주공13단지,67,40,107,37.6667468606,127.063432919
11562,노원역10번출구,105,1740,1845,37.6566407298,127.0644341674
11566,한신1차아파트정문,18,67,85,37.665426804,127.068237921
11567,보람아파트정문,549,247,796,37.6645548999,127.0644308067
11571,한신3차아파트,23,120,143,37.665476,127.067273
11576,상계주공15단지,234,41,275,37.6706380752,127.0536169926
11577,보람사거리,436,107,543,37.6643687096,127.0670671762
11583,청솔7단지아파트,4,26,30,37.6317303507,127.0722281429
11587,대림아파트105동앞,112,47,159,37.6628687433,127.0737280558
11590,상계6동우체국,293,408,701,37.6536989107,127.0588725833
11594,석계역,225,195,420,37.615421632,127.0644586182
11595,노원역2번출구,2480,192,2672,37.6562751871,127.0631567004
11596,노원역5번출구,972,632,1604,37.6543273712,127.0616021898
11597,중현초등학교,3,38,41,37.6329598124,127.0669924831
11599,월계472교,0,23,23,37.6158813474,127.0607559977
11601,KT플라자노원점,443,156,599,37.654889655,127.0636626522
11602,중계센트럴파크아파트,0,54,54,37.6437893671,127.0596902572
11603,장석교회,34,11,45,37.6242668613,127.0509399385
11604,교육촌.벼루말,194,16,210,37.6218672206,127.0526752265
11605,꿈의숲SK뷰아파트,57,18,75,37.6208711896,127.0536514986
11607,석계역문화공원,721,491,1212,37.6148875788,127.0643656736
11609,꿈의숲SK뷰아파트,10,102,112,37.6208778929,127.0537704394
11634,하계장미아파트정문,24,52,76,37.6340828467,127.0664870208
11664,불암산역,14,1,15,37.6692446012,127.0784855626
11675,동신아파트,102,125,227,37.6173040527,127.0609644558
11680,순복음교회,14,22,36,37.6553098844,127.0659777956
11723,하계역,143,58,201,37.6353446877,127.0683618531
11781,지에스마트,211,82,293,37.6637908331,127.0659762338
11784,보람아파트상가,342,395,737,37.6646590132,127.0651801458
11793,삼창아파트,165,131,296,37.618195896,127.0596522656
11796,포레나노원,7,292,299,37.6631858244,127.0616933878
11801,청솔7단지앞,87,63,150,37.6315960409,127.0723073234
11803,경춘선숲길방문자센터,172,164,336,37.6316152129,127.0704050243
11804,메디아이산부인과,36,51,87,37.6564915397,127.0669716859
11818,보람1차후문,225,46,271,37.6621032692,127.065699307
11819,상계주공13단지,6,145,151,37.6666698801,127.0638597271
11842,선곡경로당,98,33,131,37.61708085,127.0586613199
11843,청백아파트4단지,107,25,132,37.6322084397,127.0523483204
11844,청백아파트4단지,3,200,203,37.6325284238,127.0525501962
11845,월계주공2단지앞,172,98,270,37.6292003493,127.0546628905
11846,인덕대후문,76,135,211,37.6293422007,127.0547791118
11847,청원고등학교,26,323,349,37.6646214365,127.0613182514
11848,청백아파트종점,4,289,293,37.6355589675,127.0524831681
11866,상계2동주민센터,61,22,83,37.6580461346,127.0682709722
11867,온곡중학교,114,55,169,37.6604211521,127.0653475903
11868,청원고등학교후문,105,231,336,37.6670774308,127.061973194
11869,월계472교,1,30,31,37.6157506698,127.0607955382
11874,석계역,125,205,330,37.6152947954,127.0639696032
11875,마들역,65,155,220,37.6644779771,127.0568606257
11879,수락리버시티3.4단지,542,927,1469,37.687056013,127.0528498554
11880,14단지상가,27,221,248,37.6698782533,127.0596913435
11881,월계1동경로당.농협,99,26,125,37.6166561998,127.0643090243
11882,동일초등학교,3,74,77,37.6644124259,127.0557933772
11884,월계1동주민센터,57,32,89,37.6193859905,127.0635603154
11885,주공11단지성당,14,91,105,37.6644946663,127.0534873722
11886,건민약국앞,50,18,68,37.6252418718,127.071869529
11887,상계주공14단지,9,127,136,37.6706636759,127.0566788642
11888,광운대역,275,63,338,37.6231879357,127.0613442435
11890,대아아파트,34,9,43,37.6229882552,127.0711682681
11893,대주아파트,43,14,57,37.6215621284,127.0716879666
11894,7호선수락산역,15,234,249,37.6755694441,127.0560307331
11897,대동아파트,3,11,14,37.6196579989,127.0721221193
11898,성원아파트,32,130,162,37.6603174005,127.0655775882
11899,수락산디자인거리,0,47,47,37.6748739104,127.0576989633
11901,공릉1동삼익아파트,10,21,31,37.6183293199,127.0725315452
11902,보람1차후문,52,217,269,37.6621166411,127.0659577499
11903,수락현대아파트,7,101,108,37.6743422459,127.059571351
11904,하계실버센터,22,64,86,37.6337428922,127.0648936512
11906,지에스마트,15,216,231,37.6634077801,127.0661459181
11907,벽산상가,13,44,57,37.6354312046,127.0658820328
11910,현대우성아파트,22,87,109,37.6370290736,127.0651882488
11915,미도아파트앞,1,23,24,37.6447970339,127.060864533
11916,상계현대3차아파트,52,194,246,37.6707308288,127.053742889
11927,원자력병원입구,67,214,281,37.6273693051,127.0775985987
11928,상원초등학교,45,170,215,37.6679870315,127.0605993817
11929,상원중학교,58,318,376,37.671119003,127.0579499838
11931,노원역8번출구,534,498,1032,37.6553199153,127.0592603529
11933,서울과학기술대학교정문앞,28,78,106,37.630292744,127.0771008584
11934,대학본부앞,0,104,104,37.6321298894,127.0787105035
11935,붕어방,369,251,620,37.6338600495,127.077919884
11936,대학본부앞,33,1,34,37.6320633528,127.0784951609
11937,서울과학기술대학교정문앞,17,7,24,37.6311853983,127.0775867046
11938,중계그린아파트,49,26,75,37.6407016676,127.0641790384
11939,브라운스톤중계,27,73,100,37.640479158,127.0640734649
11990,불암산역,2,119,121,37.6706170199,127.079711295
11995,상계3.4동주민센터,4,31,35,37.6730037112,127.0834249516
12001,덕은교.은평차고지앞,945,412,1357,37.5895977455,126.884114477
12002,덕은교.은평차고지앞,671,944,1615,37.5891649798,126.8847866387
12003,수색교,1278,547,1825,37.5857595064,126.8886727095
12004,수색교,239,881,1120,37.5846958272,126.8901789227
12005,수색역앞,2110,1034,3144,37.5832230348,126.8932380184
12006,수색역앞,757,2108,2865,37.583047,126.894103
12007,디지털미디어시티역,2906,2729,5635,37.579047,126.900505
12008,디지털미디어시티역,2473,2391,4864,37.5786172251,126.9013445361
12009,은평뉴타운10단지,79,560,639,37.642948,126.915165
12010,은평뉴타운10단지,702,122,824,37.643407,126.91373
12011,구파발역입구,266,900,1166,37.636164,126.917023
12012,구파발역입구,590,277,867,37.637116,126.916837
12013,박석고개.신도고등학교,418,1112,1530,37.629919,126.919374
12014,박석고개.신도고등학교,1385,443,1828,37.631088,126.919017
12015,세명컴퓨터고등학교,429,1418,1847,37.6242147932,126.9199734902
12016,세명컴퓨터고등학교,1974,809,2783,37.6252825924,126.9199961366
12017,연신내역.연서시장,2232,1472,3704,37.6183598996,126.9218398322
12018,연신내역.연서시장,1415,2021,3436,37.6193225551,126.9209337015
12019,동명여고.천주교불광동성당,691,1434,2125,37.6156068499,126.9250897142
12020,동명여고.천주교불광동성당,1121,764,1885,37.6161715335,126.9240159589
12021,불광역3.6호선,1663,1397,3060,37.6119112959,126.9287979055
12022,불광역3.6호선,1235,1204,2439,37.6124473901,126.9281552459
12023,불광역3호선.서울혁신파크,1273,1620,2893,37.6086506795,126.9316257787
12024,불광역3호선.서울혁신파크,2258,1648,3906,37.6090648082,126.9310647897
12025,한전서대문은평.북한산푸르지오,809,1323,2132,37.6055573158,126.934329604
12026,한전서대문은평.북한산푸르지오,1375,798,2173,37.6060931118,126.9338053516
12027,녹번역,1243,1582,2825,37.6018619707,126.935322042
12028,녹번역,874,961,1835,37.6024349118,126.9350485981
12101,신사1동주민센터,348,851,1199,37.598063,126.911347
12103,불광역1번출구,66,378,444,37.6100879267,126.9304602536
12104,불광역3.6호선,96,204,300,37.6124835753,126.9283885506
12105,동명여고,30,186,216,37.616295,126.924228
12106,연신내역,1180,1174,2354,37.6181925106,126.9221617234
12107,선일하이츠빌라,71,85,156,37.6227910995,126.919942637
12109,세명컴퓨터고등학교,76,133,209,37.6257486454,126.9202811322
12111,구파발역2번출구,3491,2261,5752,37.6367680033,126.9189889746
12112,구파발역.롯데몰,3622,2099,5721,37.637248,126.918577
12113,구파발역.롯데몰,39,1218,1257,37.6372464535,126.9185307406
12117,박석고개,81,81,162,37.6262373755,126.9198715831
12118,신한은행갈현지점,29,58,87,37.6238469574,126.9196883967
12119,연신내역,1320,628,1948,37.617346376,126.9225592814
12120,동명여고,463,271,734,37.6159770824,126.9240648193
12121,불광역3.6호선,154,92,246,37.6126668394,126.9278448811
12125,녹번역,4820,2132,6952,37.601221,126.932868
12126,은평구청,2206,1497,3703,37.6014275543,126.930407158
12127,응암지구대,1242,1336,2578,37.6013998544,126.926337939
12128,본서부병원,1082,1434,2516,37.6008996231,126.9237965161
12129,신진과학기술고교.이마트은평점,964,795,1759,37.5998598128,126.918510745
12130,응암역신사오거리,3220,1489,4709,37.5990352266,126.9148666663
12131,응암역신사오거리,1189,2142,3331,37.5987592495,126.9149894161
12132,신진과학기술고교.이마트은평점,958,783,1741,37.5995376513,126.9186295811
12133,본서부병원,1636,1475,3111,37.6005501772,126.9235787889
12134,응암지구대,1038,1097,2135,37.6012216354,126.9266529623
12135,은평구청,1756,3273,5029,37.6011965196,126.9303925947
12137,녹번초등학교,450,489,939,37.6028391102,126.92615785
12138,역촌역.역촌오거리,1556,1243,2799,37.606957085,126.9224758463
12139,삼성타운,396,824,1220,37.6087032927,126.9209709958
12140,구산역1번출구.예일여고,620,1344,1964,37.6108522823,126.918180036
12141,역촌중앙시장,505,749,1254,37.612815754,126.9147150471
12142,구산사거리,295,686,981,37.613613,126.912487
12143,선진운수종점,575,1096,1671,37.6143442807,126.9104574621
12144,선정중고등학교,135,694,829,37.6158315758,126.9083885964
12145,서울경찰청86.87기동대.우남아파트,81,443,524,37.618049,126.906434
12146,서울경찰청86.87기동대.우남아파트,362,90,452,37.6185284274,126.9058308185
12147,선정중고등학교,571,247,818,37.6157164599,126.9080800916
12148,선진운수종점,2844,516,3360,37.6138985962,126.910860076
12149,구산사거리,429,315,744,37.6132406179,126.9125387021
12150,역촌중앙시장,882,481,1363,37.6125210285,126.9146767259
12151,구산역2번출구.예일여고,1492,1118,2610,37.6107737973,126.9177586143
12152,하나은행역촌동지점,580,501,1081,37.6092676452,126.9200382135
12153,역촌역.역촌오거리,941,758,1699,37.6065740745,126.9224014904
12154,녹번초등학교,486,341,827,37.603666166,126.9250309695
12155,응암초등학교,572,411,983,37.5870793679,126.9211239608
12156,은평문화예술정보학교,531,622,1153,37.5888974078,126.9189004955
12157,응암오거리,1094,1266,2360,37.5907361763,126.9165521769
12158,신사초등학교,1189,754,1943,37.5931399182,126.9135451755
12159,신사동고개사거리,98,293,391,37.5960379684,126.9098622734
12160,신사동고개사거리,781,479,1260,37.5956071263,126.9099682771
12161,신사초등학교,237,1209,1446,37.5933583703,126.9128484808
12162,응암오거리,1014,1112,2126,37.5907322847,126.916146787
12163,은평문화예술정보학교,635,574,1209,37.5888296386,126.9186175094
12164,응암초등학교,443,612,1055,37.5874770514,126.9203088175
12165,대림시장,857,947,1804,37.5878268986,126.9165435736
12166,대림시장,1565,675,2240,37.5886847389,126.9170368506
12167,응암역.신사오거리,791,484,1275,37.5979358249,126.9152247795
12168,신흥시장,526,507,1033,37.5954014899,126.9145640351
12169,새절역.숭실고입구,1118,2385,3503,37.5906960085,126.9133950466
12170,와산교,279,229,508,37.587889553,126.9126985944
12172,증산종합시장.증산중학교입구,635,508,1143,37.5808308281,126.9061474532
12173,증산종합시장.증산중학교입구,853,932,1785,37.5805912987,126.9063881275
12174,증산역.증산동주민센터,2034,650,2684,37.5836809982,126.909681456
12175,와산교,378,394,772,37.5880943849,126.9130844852
12176,새절역.숭실고입구,3776,1682,5458,37.5916824313,126.9138927882
12177,신흥시장,508,576,1084,37.5954017296,126.9148958447
12178,응암역.신사오거리,530,913,1443,37.5981073049,126.9156062368
12179,역촌초등학교,503,438,941,37.6021814396,126.9160546584
12180,역말사거리,896,672,1568,37.6061494708,126.9155586421
12181,구산역2번출구.예일여고,545,976,1521,37.6099512058,126.9169033629
12182,구산역1번출구,1410,759,2169,37.6116583062,126.91753691
12183,대조동주민센터,700,1611,2311,37.6140725919,126.9179363667
12184,연신내역.로데오거리,1597,4519,6116,37.6178207167,126.9199962033
12185,연서시장,3510,956,4466,37.6192425563,126.9225910997
12186,종로약국,422,901,1323,37.6203765441,126.9246380909
12187,불광지구대,374,1575,1949,37.6217745784,126.9267891079
12188,북한산대창센시티아파트,275,1376,1651,37.6248070601,126.9288094985
12189,은평경찰서,438,731,1169,37.6276323558,126.9294752418
12190,폭포동,172,515,687,37.630715,126.931032
12192,신도중학교,496,225,721,37.6333482679,126.9315290754
12195,은평노인종합복지관.신도중학교,163,670,833,37.632495,126.931533
12197,폭포동.은평노인종합복지관,647,245,892,37.6313826666,126.9310069167
12198,은평경찰서,1033,601,1634,37.6281128817,126.9292714833
12199,연신초등학교,1908,306,2214,37.6256234179,126.9287702008
12200,불광지구대,1638,403,2041,37.6218554999,126.926505814
12201,새장골유래비,520,1185,1705,37.6205196512,126.9243796594
12202,연서시장,1490,2782,4272,37.619596645,126.9225340914
12203,연신내역.로데오거리,3622,869,4491,37.618013317,126.9196550241
12204,은평연세병원,683,648,1331,37.6147392532,126.9177313127
12205,구산역4번출구,389,679,1068,37.6118940018,126.9171879732
12206,구산역3번출구.예일여고,1242,694,1936,37.6105039368,126.9167761276
12207,역말사거리,849,763,1612,37.6062104465,126.9151429014
12208,역촌초등학교,365,416,781,37.6027929337,126.9155726294
12209,응암역2번출구,228,425,653,37.6004214787,126.9158607077
12210,신사동고개.은평지역자활센터,332,665,997,37.5984133304,126.910253684
12211,서울기독대학교입구,762,2049,2811,37.6014374785,126.9103848244
12212,시립서북병원세현교회앞,420,1826,2246,37.6061458636,126.910658933
12213,구산중학교.구산교회,269,1036,1305,37.608955,126.91102
12214,구산동주민센터,95,552,647,37.61138,126.911363
12215,구산동주민센터,632,169,801,37.6122095685,126.9112924774
12216,구산중학교.구산교회,1383,314,1697,37.6088023972,126.9108335829
12217,시립서북병원세현교회앞,1920,402,2322,37.6060168573,126.9104597465
12218,서울기독대학교입구,1784,455,2239,37.6020320757,126.9102266857
12219,우남교통,1275,361,1636,37.5997666658,126.9101252157
12220,신사동고개.은평지역자활센터,865,134,999,37.5986006142,126.9100665956
12221,갈현1동주민센터,81,115,196,37.623967591,126.9169240149
12222,한일탕,203,107,310,37.626073,126.918368
12223,한일탕,61,165,226,37.626162,126.918707
12224,갈현1동주민센터,165,138,303,37.6232468092,126.9170449022
12225,불광롯데캐슬아파트,265,205,470,37.6130745033,126.9320721326
12227,진관초교입구,23,9,32,37.6469051663,126.9258465241
12229,푸르지오625동앞.관음사입구,246,10,256,37.6489838336,126.9286737884
12230,삼천리골입구56사단북한산부대,73,198,271,37.6504258786,126.9351054314
12231,백화사,3,67,70,37.653550933,126.9389594548
12232,흥국사,0,64,64,37.656762115,126.9420101744
12233,북한산성입구,6,180,186,37.6580874009,126.9453651665
12234,북한산성입구,153,3,156,37.6581874095,126.9453412916
12235,흥국사,37,0,37,37.6572667556,126.9421886946
12236,백화사,52,4,56,37.6537446878,126.9390034965
12237,삼천리골입구56사단북한산부대,108,42,150,37.6500812402,126.9333102284
12238,진관초교관음사입구,14,146,160,37.6477735446,126.926868987
12239,푸르지오618동앞.관음사입구,1,85,86,37.6496846837,126.9292312003
12240,진관중고교약수사입구,4,52,56,37.6456049544,126.9233824457
12241,응암2동주민센터,444,138,582,37.5959245549,126.9236015835
12242,응암2동주민센터,152,620,772,37.5956531408,126.9230828294
12243,이마트.은평점,317,379,696,37.6000492124,126.918585473
12244,서부경찰서,403,191,594,37.6013637746,126.920594101
12245,해주드림빌APT,77,130,207,37.604167052,126.9220664791
12246,역촌역.역촌오거리,368,273,641,37.6068015906,126.923243231
12247,대조시장앞,137,384,521,37.6086555139,126.9265165396
12248,양광교회앞,430,429,859,37.6084619409,126.9282417636
12249,불광역.불광1동주민센터,1559,540,2099,37.6090959943,126.9322904306
12250,독박골.북한산래미안APT앞,180,261,441,37.610512964,126.9397954573
12251,구기터널입구,9,160,169,37.6104100652,126.9449374785
12252,구기터널입구,4,57,61,37.6107519472,126.9457747343
12253,독박골.북한산래미안APT,526,397,923,37.6107435434,126.9396027141
12254,불광역.불광1동주민센터,461,1579,2040,37.6095286975,126.9326083189
12255,양광교회,455,147,602,37.6085452704,126.9289518591
12256,대조시장,651,202,853,37.6087915452,126.9261611387
12257,역촌오거리,125,282,407,37.6076554963,126.9239679445
12258,역촌역1번출구,185,239,424,37.6052406679,126.9221735304
12259,서부경찰서,277,337,614,37.6020192141,126.9205481069
12260,이마트.은평점,270,241,511,37.6002403634,126.9181379622
12261,응암1동주민센터,426,614,1040,37.6001514291,126.9267670248
12262,영락중학교입구,142,492,634,37.5973360696,126.9243403259
12263,시립은평병원,314,704,1018,37.5932001174,126.9229692929
12264,백련산힐스테이트4차,277,428,705,37.5900103713,126.9226750731
12265,충암고교앞.대주피오레아파트,63,303,366,37.5868458253,126.9226529706
12266,충암고교앞.대주피오레아파트,302,146,448,37.5869567896,126.9228521457
12267,백련산힐스테이트2차,470,293,763,37.5903133577,126.9228701963
12268,시립은평병원,871,296,1167,37.5932858149,126.9231277275
12269,영락중학교입구,265,129,394,37.5969092616,126.92416574
12270,응암1동주민센터,254,353,607,37.600396483,126.9270456288
12271,한솔아파트입구선정중학교후문,925,264,1189,37.6157960537,126.9137069892
12272,갈현동미미아파트,215,267,482,37.6182029973,126.9151519292
12273,선일여고입구,393,290,683,37.6193423695,126.9157125131
12274,갈현동성당앞,277,130,407,37.6207946411,126.9165922246
12275,갈현동성당앞,301,396,697,37.6205383043,126.9162269018
12276,선일여고입구,346,385,731,37.6194003078,126.9155259034
12277,갈현동미미아파트,201,245,446,37.6181857266,126.9149435132
12278,한솔아파트입구선정중학교후문,288,347,635,37.6160781278,126.9137542396
12279,불광역9번출구.불광초등학교,877,421,1298,37.6112854246,126.9305162707
12280,불광대호아파트,174,262,436,37.6144800026,126.9324705005
12281,불광1동공동주차장앞,143,291,434,37.6156974301,126.9329988956
12282,불광1치안센터.독바위역,189,373,562,37.6173596033,126.9331412473
12283,수리초등학교입구,407,285,692,37.6192490925,126.932556215
12284,북한산수자인아파트,69,348,417,37.6216806133,126.931665598
12285,불광중학교,188,396,584,37.6228723855,126.9309500937
12286,북한산대창센시티아파트,93,189,282,37.6237282359,126.9299354838
12287,북한산대창센시티아파트,444,153,597,37.6238488301,126.9296816036
12288,불광중학교,580,107,687,37.6225007168,126.9310525109
12289,북한산수자인아파트,235,206,441,37.6210460453,126.9316569055
12290,수리초등학교입구,332,416,748,37.6190891413,126.9325110516
12291,불광1치안센터.독바위역,564,230,794,37.6179384493,126.9330727682
12292,불광1동공동주차장앞,258,166,424,37.6163007079,126.9327287763
12293,불광대호아파트,312,300,612,37.614533,126.932333
12294,불광초등학교,537,1110,1647,37.6115701913,126.9304574428
12295,신사동고개사거리,183,526,709,37.595676,126.910343
12296,백련산SK뷰아이파크아파트,830,546,1376,37.5958464822,126.9191562245
12303,서부경찰서후문,230,429,659,37.6024326383,126.9223367061
12304,신진과학기술고등학교,1071,1122,2193,37.5979105453,126.9203231697
12305,응암시장,886,896,1782,37.5943144974,126.9179795859
12307,서서울농협본점,579,521,1100,37.593074353,126.9180372767
12308,신진과학기술고등학교,1039,677,1716,37.5978224711,126.9206733351
12309,서부경찰서후문,422,223,645,37.602673,126.922648
12310,디지털미디어시티역,1472,363,1835,37.579265,126.900601
12311,수색역,299,68,367,37.5818901726,126.8961946716
12314,덕은교.은평차고지앞,11,211,222,37.5885782748,126.885614161
12315,덕은교.은평차고지앞,573,215,788,37.589961128,126.8834469451
12316,수색교,76,1,77,37.5855616396,126.888691653
12317,수색119안전센터,23,1,24,37.583469198,126.8924280896
12318,수색역,11,237,248,37.5807252119,126.8972983814
12319,디지털미디어시티역,34,549,583,37.5782704462,126.9012938809
12320,수색초등학교,195,305,500,37.584885,126.898899
12321,e편한세상수색에코포레,546,587,1133,37.585871126,126.9002070161
12322,은평터널앞,457,817,1274,37.5916129815,126.905834169
12323,e편한세상수색에코포레,623,381,1004,37.5861018572,126.9002689854
12324,수색초등학교,210,359,569,37.58469,126.898375
12325,DMC파인시티자이,122,509,631,37.583379,126.896608
12326,DMC파인시티자이,569,143,712,37.583013,126.896455
12329,새마을금고앞,50,96,146,37.5890004737,126.9118521827
12330,새마을금고앞,21,181,202,37.5887219151,126.9123692391
12331,미성아파트앞,32,233,265,37.5899609798,126.9101243601
12332,미성아파트앞,172,39,211,37.5897240784,126.9101746617
12333,상신중학교앞,141,395,536,37.590611849,126.906453073
12334,상신중학교앞,487,145,632,37.5905277975,126.9061918911
12335,숭실고입구,1024,358,1382,37.5919492748,126.9063967491
12336,현대아파트앞,422,310,732,37.5937119295,126.9079429786
12337,현대아파트앞,218,643,861,37.5936396734,126.9077166053
12338,신사사거리,438,299,737,37.5956793509,126.9089727568
12339,신사사거리,357,470,827,37.595726085,126.9088141552
12340,동명여고후문,58,85,143,37.613396539,126.9243200422
12341,동명탕앞,46,95,141,37.6113775306,126.922048761
12343,하나은행역촌동지점,22,28,50,37.6083362023,126.9204238095
12345,충북슈퍼앞,34,13,47,37.6059929743,126.9178343774
12347,역촌동주민센터,57,17,74,37.6057279605,126.9148242474
12350,제각말5단지.은평뉴타운도서관,45,821,866,37.638398,126.93551
12351,제각말5단지.은평뉴타운도서관,956,87,1043,37.636736149,126.9344374778
12361,연신초등학교,87,301,388,37.6258964052,126.9291886235
12364,증산역.증산동주민센터,805,1576,2381,37.5837546123,126.9093224341
12365,연신초등학교.연신내성당,156,54,210,37.6268716359,126.9290432643
12366,신사동고개,224,1283,1507,37.5981632618,126.9108258962
12367,시립서북병원,243,304,547,37.6046894448,126.9103118348
12368,신사동고개,292,143,435,37.5977669942,126.9099169775
12381,녹번역,1226,5465,6691,37.6008721092,126.9342261424
12388,시립서북병원,363,196,559,37.605176,126.910563
12390,구산동사거리,416,119,535,37.6142712329,126.9122339199
12391,구산동사거리,58,288,346,37.6143667731,126.9121200751
12393,역촌동성당,269,86,355,37.6055600914,126.9121474028
12394,역촌동성당,100,183,283,37.6057372754,126.9125361624
12406,호림아파트앞,49,61,110,37.6091519314,126.9208187439
12409,은평권역공영차고지,0,69,69,37.591461986,126.8843758106
12415,응암정보도서관,174,356,530,37.5865712748,126.9198965286
12416,응암정보도서관,250,100,350,37.5867495708,126.9201891291
12417,서울중앙교회앞,308,330,638,37.5852370433,126.9181435403
12418,우성공인중개사,232,26,258,37.5850429138,126.918876351
12419,응암오거리,247,153,400,37.5908592237,126.9159858454
12420,갈현노인복지센터,26,63,89,37.6247220019,126.917214331
12421,녹번동대림JR아파트앞,206,305,511,37.5992697862,126.937210112
12422,연서중학교입구,259,227,486,37.5862294351,126.9122781788
12423,연서중학교입구,124,308,432,37.5861713747,126.9117539841
12424,지축교앞,2,36,38,37.645043752,126.9174939449
12425,지축교앞,98,10,108,37.6448493012,126.9196866859
12426,진관중고교약수사입구,41,5,46,37.6451606289,126.9229619673
12427,응암3동주민센터,322,861,1183,37.5911611009,126.9173132277
12429,롯데캐슬823동앞,303,1154,1457,37.6420727334,126.9217560692
12430,진관중고교.약수사앞,739,190,929,37.643408,126.92309
12431,아이파크701동앞,100,618,718,37.6460451246,126.9280934321
12432,푸르지오621동앞,896,178,1074,37.6484353114,126.930478843
12433,진관초교앞,95,131,226,37.6462300075,126.9293236181
12434,생태공원앞,443,370,813,37.6440749929,126.9289701583
12435,진관중고교.약수사앞,125,590,715,37.6436290464,126.9241288304
12436,래미안909동앞,1127,592,1719,37.641157,126.921548
12437,하나고.삼천사.진관사입구,113,494,607,37.641815,126.938408
12439,응암3동주민센터,704,407,1111,37.5916290571,126.9176960361
12440,입곡삼거리,130,57,187,37.649452,126.936391
12441,입곡삼거리,8,51,59,37.6516917235,126.9373769489
12442,아이파크709동앞,135,5,140,37.64485753,126.9266769344
12445,은진초교입구.은뜨락도서관,224,140,364,37.6307586517,126.9208007398
12446,은진초교입구.은뜨락도서관,80,250,330,37.6310195075,126.9209179115
12447,은평구민체육센터앞,109,156,265,37.631421,126.922569
12448,은평구민체육센터앞,129,195,324,37.6316559976,126.9232490659
12449,신도초중교입구.한국고전번역원,376,199,575,37.6314891556,126.9253371709
12450,신도초중교입구.한국고전번역원,305,412,717,37.6315631161,126.9269041367
12451,은평성모병원,24,493,517,37.6332275182,126.9177505869
12453,아이파크714동앞,101,819,920,37.6447747188,126.926199185
12455,푸르지오604동앞,75,492,567,37.6477638516,126.9300942037
12456,푸르지오614동앞,73,241,314,37.649745,126.931495
12457,아이파크708동앞,1216,123,1339,37.6456334846,126.9271303103
12458,진관동주민센터.은평우체국,687,152,839,37.6345427048,126.9197809696
12459,진관동주민센터.은평우체국,103,503,606,37.634698,126.91982
12460,동부센트레빌324동앞,205,282,487,37.6341556356,126.9246490829
12461,두산위브253동앞,109,245,354,37.6342740607,126.9231676603
12462,동부센트레빌320동앞,343,626,969,37.6340945394,126.9278043408
12463,신도초교.은평메디텍고등학교,830,524,1354,37.6343139033,126.9292486123
12464,하나고.삼천사.진관사입구,756,89,845,37.6417643622,126.9381067653
12465,두산위브205동앞,513,222,735,37.6342668645,126.9262624499
12466,래미안922동앞,547,6,553,37.6440800714,126.9213361406
12467,롯데캐슬820동앞,4,245,249,37.6440018231,126.921569335
12469,진관공영차고지,209,19,228,37.6466539601,126.9079541625
12470,진관공영차고지,11,232,243,37.6465977481,126.9080817073
12471,기자촌11단지앞,38,639,677,37.634757,126.93258
12472,수국사입구,398,62,460,37.61677185,126.9067818944
12473,응암초교.백련산힐스테이트3차,490,199,689,37.5887478897,126.9228091836
12474,신도초교.은평메디텍고등학교,331,544,875,37.6340923943,126.93053931
12475,응암초교.백련산힐스테이트3차,137,261,398,37.5883344878,126.9225525515
12476,녹번센트레빌아파트,431,223,654,37.5987999451,126.9259022216
12477,녹번센트레빌아파트,131,372,503,37.5991595285,126.925981141
12478,선진운수종점,123,1019,1142,37.6143774179,126.9096051215
12479,기자촌사거리,112,16,128,37.6344327251,126.932131807
12480,갈현중앙시장,125,243,368,37.6234657781,126.9183928591
12481,갈현중앙시장,243,216,459,37.6233585723,126.9189621884
12498,덕산중학교.씨티아파트,208,60,268,37.6001887986,126.9045107403
12499,덕산중학교.두산위브아파트,75,267,342,37.6003715553,126.9045804777
12500,대성중.고등학교,502,554,1056,37.622241841,126.9113648182
12501,시립은평병원.파크자이아파트,63,6,69,37.5933751468,126.9219585281
12502,경향파크아파트,289,238,527,37.6098126903,126.9064058814
12503,12번지건영아파트,246,231,477,37.6292661384,126.9139681277
12504,상신초교.두산.한신아파트,104,66,170,37.5995793833,126.906505892
12506,선일여고.빅데이터고,78,8,86,37.6205134295,126.9127522188
12507,신비로마트,173,44,217,37.5935080891,126.9207130204
12508,대동슈퍼,66,1,67,37.6091453914,126.9069186823
12509,미미슈퍼,27,2,29,37.6287486686,126.9145009345
12510,신사1동경로당,71,1,72,37.6011047367,126.9065878058
12512,미미아파트,227,27,254,37.6193298376,126.9145751762
12513,응암시장입구,155,74,229,37.5938507341,126.9184081548
12514,구산근린공원.GS편의점,141,2,143,37.6078442485,126.9081005205
12515,충남슈퍼,123,2,125,37.6281888678,126.9152380123
12516,라이프씨티후문.광성교회,95,0,95,37.6019571245,126.9065369075
12518,갈현초교.로데오거리,33,75,108,37.6183017293,126.9171432868
12520,구산마트,139,14,153,37.6075149639,126.9099346707
12521,신창슈퍼,142,5,147,37.6275398834,126.9162130815
12522,역촌센트레빌,66,0,66,37.6036440665,126.9066729719
12524,연신내역.물빛공원,425,1622,2047,37.6179370025,126.9200640466
12525,금호아파트,23,56,79,37.5991458825,126.9215937962
12526,엔에스아파트,155,17,172,37.6074009938,126.9129600864
12527,대한슈퍼,34,8,42,37.6264916063,126.9170390302
12528,천사원입구.서북병원,234,8,242,37.6046059597,126.9072233446
12531,서부경찰서후문,138,102,240,37.6011577098,126.922503383
12532,미주아트빌,66,57,123,37.607360642,126.9144620117
12533,한일탕,37,13,50,37.6258625007,126.9181148695
12534,GS편의점.제일영광교회,66,3,69,37.6038691675,126.9090006442
12536,응암지구대,57,52,109,37.6026268302,126.9266541847
12538,동아문구,27,40,67,37.6250653271,126.9172320767
12539,역촌노인복지관,73,21,94,37.6029022786,126.9110909239
12540,불광보건소,6,142,148,37.6212263774,126.9276959244
12541,은평문화예술회관,143,57,200,37.6036578292,126.9275532384
12542,구산전철역,178,71,249,37.6107888716,126.9176987121
12543,갈현1동주민센터,134,76,210,37.6237981731,126.9169038114
12544,역촌초등학교후문,42,43,85,37.6021657689,126.9130783097
12545,금강골드,3,146,149,37.6220396778,126.9300582848
12546,현대아파트,117,55,172,37.6052022296,126.9289335194
12547,삼성아파트후문,92,32,124,37.6094541116,126.9212918796
12548,우리들약국,55,109,164,37.6023270787,126.9155822164
12549,불광중학교,2,180,182,37.6223118057,126.9315964607
12550,삼거리,74,112,186,37.6060269864,126.9308932967
12551,동명탕,121,25,146,37.6113704609,126.9222594504
12554,불광동팀수양관,144,90,234,37.6225815388,126.9337169448
12555,서울혁신파크,135,95,230,37.6064338527,126.933287288
12556,동명여고후문,51,111,162,37.6134047996,126.9245556417
12557,은평성모병원,283,215,498,37.633821,126.915263
12559,불광중학교,171,0,171,37.6225288027,126.9315479397
12560,녹번전철역,1827,500,2327,37.6016520167,126.9352219968
12561,대조동우체국,237,313,550,37.6130918108,126.9266354132
12562,하나은행역촌동지점,11,45,56,37.6082433296,126.9203621159
12564,금강골드,94,1,95,37.6221532998,126.930019077
12566,불광역4번출구,1126,1285,2411,37.6097874644,126.9304044087
12567,갈현1동주민센터,88,135,223,37.6234667674,126.9171783379
12569,불광보건소,84,15,99,37.6214750716,126.927728474
12571,양광교회앞,267,87,354,37.6085524361,126.9288804949
12572,갈현노인복지센터,33,95,128,37.6249708087,126.9173681302
12577,한일탕,42,63,105,37.6257490703,126.9182679378
12581,연신내역.물빛공원,1138,145,1283,37.6179484142,126.9196188444
12582,서강스카이빌,154,130,284,37.599637866,126.9215785571
12584,금원빌라,1,139,140,37.6273083678,126.9182215668
12585,갈현초교.로데오거리,34,99,133,37.6183891774,126.9172043613
12588,영진빌라,2,177,179,37.6280239699,126.9172282867
12589,미미아파트,55,252,307,37.6194836087,126.9147744045
12590,응암시장입구,148,262,410,37.5936340537,126.9191082332
12592,일진빌라,0,134,134,37.6286459709,126.9165086746
12593,선일여고.빅데이터고,71,261,332,37.6205854307,126.9128739979
12594,신비로마트,66,284,350,37.593465478,126.9203269078
12595,미주아트빌,27,130,157,37.6074762806,126.9148764255
12596,미곡빌라,2,110,112,37.6292031766,126.9157102264
12598,시립은평병원.파크자이아파트,21,209,230,37.5931591443,126.9223154295
12599,엔에스아파트,27,97,124,37.6075146741,126.9131547681
12600,양지빌라,5,52,57,37.6287104174,126.9149120747
12603,구산마트,14,207,221,37.6076913632,126.9100391865
12612,하나은행역촌동지점,47,67,114,37.6083549287,126.9201615172
12615,구산근린공원.GS편의점,0,119,119,37.6078265542,126.9085218863
12623,은평마을,0,57,57,37.60822376,126.9072186213
12627,대동슈퍼,1,62,63,37.6091680559,126.9070930846
12679,우리들약국,175,69,244,37.6024207649,126.915544736
12682,역촌초등학교후문,28,55,83,37.6022657636,126.913043084
12684,역촌노인복지관,47,75,122,37.6030076903,126.9110704122
12685,GS편의점.제일영광교회,5,77,82,37.6039125765,126.9089627251
12705,천사원입구,6,191,197,37.6047114321,126.9072809761
12706,역촌센트레빌,2,88,90,37.6036115181,126.9065348376
12713,라이프씨티아파트후문.광성교회,0,105,105,37.6019984659,126.9063998164
12714,신사1동경로당,0,66,66,37.6010559497,126.9064259132
12723,은평공영차고지,0,18,18,37.5913387098,126.8832624811
12725,연신내역6번출구,1464,997,2461,37.6187941297,126.920609953
12727,상신초교.두산.한신아파트,10,10,20,37.5996258649,126.9063506929
12733,청구성심병원후문,44,53,97,37.6203235076,126.9193772591
12750,연갈현공판장후문,84,142,226,37.6231941796,126.9191124639
12792,삼성래미안아파트,111,0,111,37.6113931879,126.9379628881
12794,현대힐스테이트1차정문,155,1,156,37.6120189102,126.937084611
12795,현대힐스테이트1차후문,121,5,126,37.6122743017,126.9358352057
12804,현대홈타운아파트,14,36,50,37.6121205904,126.9332606867
12806,불광역9번출구,599,27,626,37.6110519588,126.9302407459
12807,현대홈타운아파트,21,72,93,37.6119764495,126.9333185837
12808,현대힐스테이트1차후문,3,254,257,37.6124118652,126.9352811899
12809,현대힐스테이트1차정문,1,420,421,37.6120344807,126.936716506
12810,삼성래미안아파트,4,124,128,37.6110914359,126.9380064656
12811,힐스테이트302동앞,117,0,117,37.5883424842,126.9253747237
12812,힐스테이트116동앞,299,2,301,37.589629845,126.9249091668
12813,서울연은초등학교,196,3,199,37.5907478447,126.9245151054
12814,힐스테이트1단지정문앞,357,13,370,37.5915036842,126.9242436989
12816,힐스테이트2단지후문앞,11,612,623,37.5920072263,126.923985
12817,서울연은초등학교,3,257,260,37.5905405474,126.9244417099
12818,힐스테이트212동앞,3,343,346,37.5894937244,126.9248209789
12819,힐스테이트302동앞,13,152,165,37.5881177776,126.9253154119
12820,태평양약국,3,10,13,37.5931110564,126.9178287272
12821,국민은행,43,66,109,37.5898036255,126.9166596611
12827,풍림아그네스앞,77,33,110,37.6030068196,126.9186054162
12828,역촌유치원입구,73,12,85,37.6041610114,126.9184603197
12829,새생명약국앞,92,36,128,37.6060224907,126.9182215705
12830,새생명약국앞,29,101,130,37.6059584123,126.9180755331
12831,역촌유치원입구,16,86,102,37.6041473815,126.9182961091
12832,풍림아그네스앞,56,54,110,37.6029499433,126.9184491833
12833,대림e편한세상1단지,114,0,114,37.6122236066,126.9061448253
12834,대림e편한세상2단지,148,1,149,37.6128333067,126.9066309054
12835,현대아파트입구,148,2,150,37.6133377398,126.9064105253
12836,임창빌라,178,35,213,37.6136305946,126.9079807238
12837,온누리약국,229,37,266,37.6143112872,126.9091981199
12838,G캐슬아파트,93,20,113,37.6152059361,126.9150771747
12839,길마어린이공원,44,39,83,37.6148011476,126.9160551992
12840,길천사우나,22,137,159,37.6142901678,126.9172394904
12841,대림모터스,5,219,224,37.6145006565,126.9180072593
12842,연서시장,777,386,1163,37.6195798013,126.9210136547
12843,청구성심병원,47,35,82,37.6208558722,126.9191023707
12844,아름다운교회,1,9,10,37.6163142927,126.9185422575
12845,길마어린이공원,7,122,129,37.6149318595,126.9161595705
12846,G캐슬아파트,6,177,183,37.6152443908,126.9153720356
12847,한솔아파트입구,31,352,383,37.6158421464,126.9138949752
12848,온누리약국,79,182,261,37.6143933425,126.9092716485
12849,임창빌라,1,174,175,37.6137483452,126.9083379258
12850,현대아파트입구,4,287,291,37.6134594849,126.9065349731
12851,대림e편한세상2단지,2,103,105,37.612863109,126.9064477086
12852,대림e편한세상1단지,266,182,448,37.6122933971,126.9060994338
12853,와산교,45,166,211,37.5888854535,126.9141942524
12854,서울정형외과,83,35,118,37.5952882098,126.9187565139
12855,벧엘블래스빌,34,128,162,37.5954033834,126.9185163078
12856,숭실고등학교,233,341,574,37.5924359314,126.9037465738
12857,숭실고등학교입구,97,3,100,37.5922844503,126.9058386761
12858,서신초교.내를건너서숲으로도서관,20,5,25,37.5916437305,126.9074020312
12859,삼거리.명진아파트,11,33,44,37.5904186369,126.9106559732
12860,안디옥교회.새절역,53,240,293,37.5903413838,126.9127733944
12861,신사초등학교.새절역,475,49,524,37.5931645919,126.9134793725
12863,상신초등학교입구,55,133,188,37.5967350848,126.9080526428
12864,행운슈퍼,16,251,267,37.5959549827,126.9059234022
12865,상신초교후문.산새마을종점,140,161,301,37.5968616877,126.9051264097
12866,행운슈퍼,105,2,107,37.5958997274,126.9057839273
12867,상신초등학교입구,362,121,483,37.5966000242,126.9084801208
12869,새절역,471,186,657,37.590645,126.913387
12870,삼거리.명진아파트,12,44,56,37.590585901,126.9104975116
12871,서신초교.내를건너서숲으로도서관,2,78,80,37.5918058667,126.9073480469
12872,숭실고등학교입구,10,112,122,37.592419547,126.905773399
12873,경남아너스빌.서북병원,5,279,284,37.6048441969,126.9055112666
12874,힐스테이트상가,135,33,168,37.5926436602,126.9238016009
12875,서부중앙교회,38,2,40,37.5891814717,126.9223210216
12876,응암초등학교,51,1,52,37.5893764234,126.9212381918
12877,성암문구사거리,22,2,24,37.58970267,126.9200405855
12880,응암감리교회대림시장앞,86,27,113,37.5888003875,126.9186628308
12881,응암동성당,7,18,25,37.589040611,126.9195323069
12882,성암문구사거리,3,72,75,37.5895742757,126.9200061957
12883,응암초등학교,1,134,135,37.5891693716,126.9213628305
12884,백련산힐스테이트2차앞,4,77,81,37.5893460086,126.9227921057
12885,백련산힐스테이트2차상가앞,6,80,86,37.5919747972,126.9230130166
12886,은평세무서음식문화거리,47,28,75,37.6020443537,126.9251390628
12887,은평여성인력개발센터,86,235,321,37.6072139011,126.9321452206
12888,대조시장.NC백화점,222,23,245,37.6095175554,126.9278360602
12889,행정연구원건너편,2,0,2,37.6096079683,126.9364616275
12890,파크자이105동앞,13,0,13,37.5919679769,126.9229167793
12891,브라운스톤빌앞,3,20,23,37.5905437355,126.9124577519
12900,구파발,4,938,942,37.6348480405,126.9190889597
12991,6번지입구,11,77,88,37.6268686558,126.9190319477
13001,북가좌동삼거리,1141,574,1715,37.5754463835,126.9045265135
13002,북가좌동삼거리,484,1275,1759,37.575143,126.905143
13003,DMC래미안e.편한세상요진아파트,1322,651,1973,37.5716775164,126.9096099146
13004,DMC래미안e.편한세상요진아파트,547,795,1342,37.571577,126.910313
13005,모래내시장.가좌역,2480,2238,4718,37.5690774104,126.9150627853
13006,모래내시장.가좌역,830,984,1814,37.569862,126.913786
13007,사천교,2053,1568,3621,37.5675591039,126.9181539325
13008,연희104고지앞.구성산회관,2171,2986,5157,37.56628429,126.9250825384
13009,연희104고지앞.구성산회관,2547,2203,4750,37.5663570321,126.9257860764
13010,서대문우체국,2228,2587,4815,37.5619524262,126.9319882204
13011,서대문우체국,1168,1446,2614,37.5625326219,126.9314621185
13012,연세대앞,3517,2757,6274,37.5599563479,126.935337338
13013,연세대앞,2980,2680,5660,37.5601569117,126.9354996016
13014,세브란스병원앞,1762,1864,3626,37.5599674551,126.9384506818
13015,세브란스병원앞,2097,2277,4374,37.5601326008,126.9389236898
13016,이대후문,3548,2271,5819,37.5626001751,126.9433012302
13017,이대후문,2228,2382,4610,37.5630635031,126.943648393
13019,동교동삼거리,1722,2212,3934,37.5577646946,126.92951964
13021,신촌오거리.현대백화점,4583,3097,7680,37.5559833987,126.9345037666
13023,신촌오거리.2호선신촌역,1731,1851,3582,37.5557324618,126.9386937609
13025,이대역,1357,2657,4014,37.5568755655,126.9472705221
13026,산골고개,2102,2080,4182,37.5953018189,126.9399957025
13027,산골고개,2213,2071,4284,37.5949694506,126.940515779
13028,홍제역.서대문세무서,4856,4163,9019,37.5884908289,126.944365257
13029,홍제역.서대문세무서,4177,3763,7940,37.5878433932,126.9453225684
13030,홍제삼거리.인왕산한신휴플러스,1789,813,2602,37.585207045,126.9478427379
13031,무악재역,965,591,1556,37.5831543142,126.9498097936
13032,무악재역,1163,2345,3508,37.5818652109,126.9506553191
13033,안산초등학교,1078,712,1790,37.580686,126.951572
13034,독립문역.한성과학고,2147,2356,4503,37.5746889121,126.9575774512
13035,독립문역.한성과학고,1469,1761,3230,37.5756411364,126.9565608295
13036,영천시장,2706,3700,6406,37.5699391328,126.9625329584
13037,영천시장,2972,2032,5004,37.5695278692,126.9631353297
13038,서대문역,1890,3333,5223,37.5664745324,126.9658300015
13039,경찰청.동북아역사재단,2324,2900,5224,37.5624764161,126.9692243077
13040,인왕산.홍제원아파트,796,2981,3777,37.5843965104,126.9488623648
13041,경찰청.동북아역사재단,1729,1677,3406,37.564312,126.968047
13042,웨딩타운,1462,1744,3206,37.5572390055,126.9525537641
13044,아현역,2408,3750,6158,37.5573893313,126.9568854911
13045,충정로역,1910,2618,4528,37.5608580892,126.9633122036
13046,충정로역,1548,1859,3407,37.5598014128,126.9624921672
13047,서대문역사거리,1824,2570,4394,37.565579,126.966565
13094,성곡파출소,22,43,65,,
13096,성곡파출소,41,26,67,,
13106,성곡동주민센터,146,75,221,,
13107,모래내시장.가좌역,1156,439,1595,37.5699234895,126.9139631219
13108,성곡동주민센터,138,152,290,,
13109,사천교,2294,2985,5279,37.5680820886,126.9175934441
13110,연희104고지앞.구성산회관,717,562,1279,37.5662972487,126.9242109644
13111,연희104고지앞.구성산회관,1148,1098,2246,37.56655,126.924998
13112,서대문우체국,360,471,831,37.5632286878,126.9304420835
13113,서대문우체국,100,66,166,37.5630010161,126.9311628502
13114,연세대학교앞,1305,2270,3575,37.5598189289,126.9353063323
13115,연대앞,160,35,195,37.560453873,126.9348360825
13116,세브란스병원,2125,2087,4212,37.5598680153,126.9378406593
13117,세브란스병원,210,52,262,37.5602647606,126.9392418031
13118,이대부중,117,804,921,37.5622161608,126.9429924976
13119,이대부중,886,1108,1994,37.5636440514,126.9441630049
13120,이대부고,905,1007,1912,37.5655323127,126.9464306606
13121,이대부고,1049,1001,2050,37.5663177634,126.9464759832
13122,홍은동동부센트레빌,68,57,125,37.5967569936,126.9387082438
13123,산골고개,70,231,301,37.59506873,126.9405745726
13124,홍은사거리.북한산더샵아파트앞,242,348,590,37.5923780828,126.9412659588
13125,홍제우체국,942,269,1211,37.586895,126.946047
13133,영천시장,735,901,1636,37.5702280395,126.9620200068
13134,금화초등학교.서울시교육청,748,1341,2089,37.5679014179,126.9643259996
13137,충정로역2호선,1144,1421,2565,37.5596112723,126.9640265994
13140,이대역,498,274,772,37.5569841725,126.9465754208
13141,신촌기차역입구,293,322,615,37.5568082054,126.9438432587
13142,신촌역2호선,507,460,967,37.5561879537,126.9396412239
13143,신촌아트레온,404,515,919,37.5565096313,126.9407880306
13144,동교동삼거리연희동방면,2780,1367,4147,37.5586582575,126.9274994875
13145,연세로.명물거리,2331,1207,3538,37.5581462307,126.9369771454
13146,연세로.스타광장,1410,2155,3565,37.5564094444,126.936763576
13147,연희동대우아파트,3572,4430,8002,37.5626233467,126.9279552211
13148,연희교차로,1571,1962,3533,37.5657,126.930163
13149,연희교차로,2764,1126,3890,37.5659472029,126.9300349043
13150,연희3거리,469,500,969,37.5678664551,126.9319224998
13151,연희3거리,2682,2172,4854,37.5679329873,126.9316095114
13152,한성화교중고교.서대문소방서,463,1471,1934,37.572300887,126.9354132782
13153,한성화교중고교.서대문소방서,1331,643,1974,37.5724773892,126.935209346
13154,서대문자연사박물관입구,755,1823,2578,37.5751696986,126.935409088
13155,서대문자연사박물관입구,1423,688,2111,37.5752259192,126.9352420646
13156,서대문구청.보건소.구의회,1530,2160,3690,37.5782448388,126.9360659508
13157,서대문구청.서대문구의회,1811,1088,2899,37.5786159669,126.9358425895
13158,수주로.수주초등학교,1466,1165,2631,37.5808305209,126.9360098808
13159,서대문보건소별관.홍제폭포,2451,2021,4472,37.5826619393,126.9362856888
13160,정원여중,628,435,1063,37.5862495334,126.9349879316
13161,정원여중.스위스그랜드호텔,1172,493,1665,37.5876617984,126.9352599978
13162,홍은현대아파트.스위스그랜드호텔,1020,960,1980,37.5886491136,126.9364277763
13163,홍은현대아파트,485,604,1089,37.5900579315,126.9383457541
13164,유진상가,839,1416,2255,37.5917540721,126.9428678255
13165,유진상가,953,435,1388,37.5921799219,126.9431392494
13166,문화촌현대아파트,444,849,1293,37.5922468351,126.9465445621
13167,문화촌현대아파트,894,651,1545,37.5926521614,126.9468069077
13168,서울여자간호대학교.홍은초등학교,879,889,1768,37.596107216,126.9492224035
13169,서울여자간호대학교.홍은초등학교,1252,868,2120,37.595642031,126.948705185
13170,유원하나아파트,324,449,773,37.595884281,126.9526777041
13171,유원하나아파트,426,378,804,37.5957428014,126.9520650666
13172,홍지문.옥천암,163,163,326,37.5965724145,126.9565922341
13173,홍지문,180,211,391,37.59691,126.956263
13174,북가좌2동주민센터,494,604,1098,37.579833,126.911478
13175,북가좌2동주민센터,1191,692,1883,37.5802996548,126.9114608746
13176,KT가좌지사,992,584,1576,37.5820367519,126.9131368767
13177,KT가좌지사,409,541,950,37.582863608,126.9134019708
13178,동도하이츠아파트,516,470,986,37.5846770601,126.9150178885
13179,동도하이츠아파트,364,414,778,37.5849012516,126.9147685281
13180,DMC파크뷰자이,1080,537,1617,37.5738624722,126.9162367644
13181,삼성래미안2차아파트,579,924,1503,37.57125,126.913812
13182,모래내삼거리,527,1112,1639,37.5707856905,126.9132772911
13183,DMC래미안e.편한세상2.4단지,1437,621,2058,37.576740896,126.9109918398
13184,모래내우체국.증가교회,353,628,981,37.5764407614,126.9117262959
13185,북가좌삼호.DMC아이파크아파트,1042,380,1422,37.5752684365,126.9133099754
13186,북가좌삼호.DMC아이파크아파트,268,852,1120,37.57553,126.913058
13188,DMC센트레빌아파트,583,1415,1998,37.575307,126.915772
13189,DMC파크뷰자이별동상가,1806,437,2243,37.575189079,126.9160852843
13190,래미안루센티아.DMC쌍용,182,262,444,37.5755669605,126.9185357219
13191,명지대사거리,479,1213,1692,37.5773706116,126.9209818476
13192,DMC에코자이아파트,242,208,450,37.5764335942,126.9195564567
13193,DMC센트럴아이파크아파트,1690,565,2255,37.5782195826,126.9218530795
13194,명지대,1128,2776,3904,37.5791366844,126.9235485995
13195,명지대,2468,721,3189,37.5798843005,126.9242905927
13196,명지대삼거리,736,1306,2042,37.5809598808,126.9260980643
13197,명지대삼거리,1586,777,2363,37.5812704533,126.926363438
13198,고은초등학교.홍제센트럴아이파크,268,412,680,37.5852299437,126.9446994488
13199,신연중학교서대문도서관,519,727,1246,37.583957533,126.9408336411
13200,백련교.홍제폭포,756,708,1464,37.5829006647,126.9375486367
13201,서대문문화체육회관입구,684,593,1277,37.5814081994,126.9353906921
13202,홍연2교두산아파트앞,306,475,781,37.5784212336,126.9308803247
13203,홍남교,60,203,263,37.576642,126.927497
13204,연가교,105,301,406,37.5725614324,126.922182071
13205,연희파크푸르지오앞,295,122,417,37.5753590003,126.9273349864
13206,홍연시장,526,100,626,37.5771334404,126.9306866952
13207,연희홍연아파트,207,76,283,37.577997674,126.9323548321
13208,서대문구청,225,185,410,37.5790506621,126.934871913
13209,남가좌현대아파트,338,450,788,37.5749175727,126.9218592217
13210,신촌기차역,1986,1583,3569,37.5587819764,126.9424516144
13211,신촌기차역,908,690,1598,37.5583564889,126.942932947
13212,증산교앞,109,68,177,37.5780399456,126.9048028539
13213,연희지하차도,233,121,354,37.5771502914,126.9325574117
13214,연희지하차도,54,287,341,37.5775014779,126.9322061541
13215,홍연2교현대교통종점,191,233,424,37.5782142202,126.9299866353
13216,홍연2교현대교통종점,295,230,525,37.5784013054,126.9302043856
13217,명지대입구.서울무용센터,421,245,666,37.5808491187,126.9274075515
13218,명지중고등학교,1293,613,1906,37.5825611977,126.9256976401
13219,명지중고등학교,967,1368,2335,37.5829327992,126.9256885404
13220,명지전문대.충암중고등학교,1680,1594,3274,37.5846658745,126.9235951233
13221,명지전문대.충암중고등학교,1463,1225,2688,37.5846680823,126.9239584623
13222,연희동자치회관,698,571,1269,37.5695181223,126.9312682155
13223,연희동자치회관,657,894,1551,37.5697475722,126.9312958858
13224,서대문구보훈회관,620,285,905,37.5717018011,126.9293638634
13225,서대문구보훈회관,153,518,671,37.5718307606,126.9295369529
13226,홍남교.서대문구행복그린센터,815,196,1011,37.5746380958,126.9269827008
13227,홍남교.서대문구행복그린센터,250,1008,1258,37.5748855063,126.9270266699
13228,백련시장,1521,365,1886,37.5766469566,126.9249301317
13229,백련시장,474,1354,1828,37.5770899891,126.9247007242
13230,명지대사거리.우리은행,1674,1120,2794,37.5774257307,126.9225808324
13231,명지대사거리국민은행앞,1023,1322,2345,37.5776103285,126.9224193215
13232,연가초교.DMC래미안클라시스,363,644,1007,37.5791189521,126.9172942879
13233,연가초.연희중.래미안클라시스,380,502,882,37.5789588794,126.91806787
13234,북가좌사거리,313,396,709,37.5811819257,126.9146690658
13235,북가좌사거리,365,301,666,37.5818379941,126.9141424887
13236,북가좌119안전센터,259,208,467,37.5827046271,126.9126208621
13237,북가좌119안전센터,113,224,337,37.5834459918,126.9120370471
13238,충정로역5호선,94,75,169,37.561714,126.964018
13240,미동초등학교,646,679,1325,37.5631581038,126.9644505142
13241,DMC한양아파트,241,419,660,37.5764898997,126.9085188895
13242,북가좌초교.DMC현대아파트,454,274,728,37.5767876006,126.9084364654
13250,독립문역.서대문형무소역사관,234,92,326,37.5754192746,126.9564326063
13252,경찰청,269,357,626,37.563413,126.968395
13256,연가교,461,157,618,37.5728168589,126.9221469551
13258,명지대입구.신원지벤스타,288,285,573,37.5804565915,126.9281505144
13259,현대백화점,1251,1095,2346,37.5566664866,126.9330023083
13260,서대문종합사회복지관,578,187,765,37.5712597156,126.9200245273
13261,서대문종합사회복지관,126,288,414,37.5709633371,126.9201437133
13262,홍남교백련시장입구,202,106,308,37.5752855695,126.9251839684
13263,북가좌초교사거리,187,250,437,37.5787263414,126.9102546757
13264,북가좌초교사거리,815,990,1805,37.578365,126.910333
13265,은가어린이공원구150번종점,862,1052,1914,37.5829339719,126.9196202751
13266,증산교앞,32,22,54,37.578311461,126.9047864601
13267,DMC두산위브아파트,270,407,677,37.5805574973,126.915323745
13268,DMC두산위브아파트,548,367,915,37.5803471667,126.915940812
13270,서대문독립공원.극동아파트,2429,1331,3760,37.5718528892,126.9593190984
13278,봉원동사거리,157,10,167,37.5668611224,126.9464767265
13279,봉원사,64,2,66,37.5701024648,126.9461047804
13280,봉원사,46,58,104,37.570109,126.9461148977
13281,봉원동사거리,14,368,382,37.5667963452,126.9467009136
13282,서대문독립공원.삼호아파트,479,549,1028,37.5714897037,126.9594106078
13285,서부운수기점,263,1,264,37.581632,126.910257
13299,중소기업은행,55,162,217,37.5822573867,126.9129894423
13313,봉원사길,112,4,116,37.5683540231,126.946017179
13314,봉원사길,4,218,222,37.5686023092,126.9461086912
13324,연세로.문학의거리,2286,881,3167,37.5562631609,126.9370041956
13325,독립공원사거리,58,26,84,37.5763938404,126.955308749
13326,독립공원사거리,73,94,167,37.5764875221,126.9552249123
13327,가재울초등학교,154,45,199,37.5739820992,126.9189766576
13328,가재울초등학교,102,110,212,37.5744342988,126.9187610612
13329,산골고개,272,46,318,37.5948326835,126.9403025508
13330,DMC래미안e-편한세상3단지,161,291,452,37.5751661304,126.9067640004
13331,DMC래미안e-편한세상3단지,276,353,629,37.5750474159,126.9070551106
13332,연흥교회,45,120,165,37.5726089786,126.9211651676
13334,홍제역4번출구,1918,2451,4369,37.5893732847,126.943082762
13335,남가좌동새마을금고,59,263,322,37.574429,126.917304
13336,국립대한민국임시정부기념관,0,12,12,37.5758314601,126.9535721283
13337,독립문파크빌.한성과학고,200,269,469,37.5745776862,126.9518579342
13338,두산아파트,103,114,217,37.578770322,126.9320567839
13339,DMC파크뷰자이,529,1459,1988,37.5737656896,126.9163415838
13340,아현가구단지,114,147,261,37.5586613075,126.9608923538
13341,DMC쌍용.래미안루센티아,177,212,389,37.575591927,126.9188102139
13499,독립문,32,325,357,37.5722659022,126.9600832725
13500,정원슈퍼,185,399,584,37.5864360186,126.9317244197
13501,홍은동국민주택,36,1,37,37.6056753028,126.9498503303
13502,백련사,46,0,46,37.5848355947,126.9285294071
13503,풍진베이스타운.안산자락길입구,45,103,148,37.5824266586,126.9433200359
13505,개미마을,5,8,13,37.589797675,126.9539148251
13506,두산아파트,106,58,164,37.5591201611,126.949261098
13507,북아현삼거리,1219,1191,2410,37.5648050703,126.9529748039
13508,궁동근린공원입구,16,110,126,37.5695765271,126.9241991219
13509,뜨란채아파트101동,55,250,305,37.565837009,126.9587733457
13510,삼성빌라,204,488,692,37.5956010964,126.9338401245
13511,소공원,62,7,69,37.5863364542,126.9325182667
13512,풍림.극동아파트,754,3,757,37.6036389041,126.9494723222
13514,명진아트빌라,39,1,40,37.5828145423,126.9436821958
13515,홍은초등학교,133,28,161,37.5968898285,126.9503226419
13516,삼거리연탄가게,18,0,18,37.5904915483,126.9533843286
13517,초원약국,158,1,159,37.5597710801,126.9500337563
13518,추계초등학교,421,2,423,37.5635916001,126.9541934784
13519,궁동근린공원회관,15,29,44,37.5709433271,126.9253683141
13520,서서울농협홍은지점.동신병원,539,23,562,37.580979243,126.9361173049
13521,뜨란채아파트.노인복지관,178,149,327,37.568067297,126.9590155058
13522,금화장오거리,332,8,340,37.5643630011,126.9592914762
13523,미성아파트,859,13,872,37.5932894508,126.9344642894
13524,삼성그린빌,71,0,71,37.5869709106,126.9326750877
13526,팔각정,7,0,7,37.5832993159,126.9301670114
13527,고은초교삼거리,6,0,6,37.5843122345,126.9438520431
13528,문화촌주유소,234,57,291,37.5952728242,126.9485919264
13529,버드나무가게,13,0,13,37.5910365086,126.9528846042
13530,신촌푸르지오1단지후문.힐스테이트신촌,343,2,345,37.5608509379,126.9516429305
13531,새마을금고,146,5,151,37.5631196895,126.9548740803
13532,서대문지역자활센터,14,40,54,37.5721234264,126.9262762163
13534,산경아파트,3,2,5,37.5685268448,126.9603003349
13535,경기대후문,59,13,72,37.5639149801,126.9614458786
13536,홍은중학교,151,3,154,37.5923361752,126.9346010147
13537,동원빌라,48,0,48,37.5870541637,126.9332966622
13538,포방공영주차장,587,7,594,37.6008891646,126.948937151
13539,서대문문화체육회관,164,1,165,37.5812287775,126.9319952523
13540,성원아파트,46,198,244,37.584232427,126.9427866202
13541,홍은사회복지관별관,315,75,390,37.5941733769,126.9480491692
13542,금강빌라.인왕중학교,43,0,43,37.5918227992,126.951991775
13544,중앙여고,711,17,728,37.5622215575,126.9555537949
13545,홍제초등학교,128,204,332,37.5922380009,126.9434055817
13546,천연동마을금고,11,29,40,37.568438466,126.9614503394
13547,미동초교,86,275,361,37.5642738059,126.9649491898
13548,차고앞,143,4,147,37.5917253952,126.9348869143
13549,싸이버아파트,35,17,52,37.5871221418,126.9340020442
13550,포방시장,402,17,419,37.5994652097,126.9483922502
13551,서대문내품애센터,92,5,97,37.5802086413,126.9333967449
13553,문화촌현대아파트,482,76,558,37.5923192809,126.9473597602
13554,오동나무앞,69,0,69,37.5928682464,126.951110117
13556,경남아파트.북아현119안전센터,146,43,189,37.5610274127,126.9558700919
13557,행복하우스,31,49,80,37.5731363439,126.9286952481
13560,삼거리,114,88,202,37.5900216603,126.9352937891
13561,정원여중입구,63,69,132,37.5864367347,126.9345801332
13562,호박골다리,240,15,255,37.5981452692,126.9467080038
13563,송죽원,250,503,753,37.5839495785,126.9390725472
13564,홍제역해링턴플레이스,49,217,266,37.5910942532,126.9467051053
13565,동성교회,54,4,58,37.5941790512,126.9496042131
13566,중앙여고,95,21,116,37.5618692519,126.9548553237
13567,한성고교,148,352,500,37.5594522562,126.9564975053
13570,현대그린마트,44,17,61,37.5713449478,126.9610204725
13571,충정로역8번출구,985,531,1516,37.5609058481,126.963069492
13572,스위스그랜드호텔앞,67,166,233,37.5889769825,126.9363704352
13574,간호대정문,194,100,294,37.596999962,126.9474272357
13575,홍은사거리,67,40,107,37.5923950001,126.9412976503
13577,인왕초등학교,314,1611,1925,37.5892500775,126.9455049823
13578,문화공원입구,43,32,75,37.5944055102,126.9483947754
13583,충정로역7번출구,1156,429,1585,37.5598644564,126.96241008
13586,산골고개,294,92,386,37.5950393216,126.9406034792
13587,홍은초등학교.간호대입구,140,109,249,37.5964555066,126.9488940175
13589,가산빌라,232,204,436,37.584882269,126.9360670682
13590,사러가쇼핑,15,9,24,37.5672943164,126.930245878
13591,영천시장입구,115,16,131,37.5692775009,126.9630256888
13592,나이스신용정보.한국예술원,77,62,139,37.5612397836,126.961904561
13593,반석블레스아파트,7,99,106,37.5951671678,126.9410116214
13594,평화슈퍼,154,175,329,37.5862688501,126.9357069372
13595,북아현로입구,253,1626,1879,37.557825,126.956271
13596,아현역1번출구,205,217,422,37.5575069757,126.9553924724
13597,육교앞,35,7,42,37.5679383551,126.9643010771
13598,광염교회,40,106,146,37.562301158,126.9619360631
13599,풍림1차아파트,15,115,130,37.5943540172,126.9420858176
13600,스위스그랜드호텔,278,138,416,37.5877677594,126.9364416698
13617,웨딩타운,98,150,248,37.5572720684,126.9515261108
13626,서대문문화체육회관,65,248,313,37.5807483392,126.9349134591
13654,서대문사거리,83,33,116,37.5666951917,126.9654574653
13656,경기대사회교육원,114,206,320,37.5633648333,126.9624252992
13659,팔각정,19,357,376,37.5952754911,126.9432424727
13660,남양아파트,108,86,194,37.5891240045,126.9383406199
13664,서대문전철역,182,41,223,37.5652797325,126.9659992155
13665,인창중고,220,82,302,37.5642130373,126.9636417757
13667,홍은유원아파트,163,571,734,37.5969649835,126.9450463638
13668,유진상가다리앞,40,227,267,37.5919205228,126.9446843067
13669,문화촌현대아파트입구,149,305,454,37.5926048425,126.9471389075
13695,종근당,12,94,106,37.5598271919,126.9629183473
13698,이대농협,63,130,193,37.5568236234,126.9440526436
13699,미동초등학교,17,10,27,37.5643964142,126.9651506262
13700,인창중고,77,21,98,37.5646637442,126.9641668008
13715,사천교,28,277,305,37.5680630996,126.9180638508
13716,벽산아파트후문,169,46,215,37.5962886959,126.9459766195
13720,현대백화점,162,226,388,37.5561694068,126.9347143466
13724,아트레온,48,139,187,37.5562630013,126.940090405
13725,신촌자이엘라,443,403,846,37.5567637834,126.9425352186
13726,인창중고,15,20,35,37.5644916315,126.9642045993
13731,연희초등학교,345,561,906,37.5699570285,126.9335745537
13737,광산사우나,136,48,184,37.5656091147,126.9645783982
13740,스위스그랜드호텔.현대아파트,347,147,494,37.5893324262,126.9363778811
13747,모래내시장,351,207,558,37.5690928967,126.9156151886
13749,연희초등학교,294,401,695,37.5697196069,126.9330310414
13751,홍은성당,30,28,58,37.5960212696,126.9464082826
13754,간호대입구.올해피장애인복지센터,54,236,290,37.5959314635,126.9491285283
13755,우리은행홍제동지점,195,175,370,37.5917792198,126.9451782303
13764,미동초등학교,6,30,36,37.5631094992,126.9648856423
13793,CGV신촌아트레온,641,665,1306,37.5557927422,126.938554851
13794,경기대후문,4,274,278,37.5640060641,126.961672228
13795,서대문성당,97,66,163,37.5672714689,126.9640444243
13796,삼거리,6,157,163,37.5900046159,126.935433086
13798,벽산아파트정문,275,77,352,37.594645127,126.9460106487
13801,서대문역7번출구,124,107,231,37.5652394638,126.9669874701
13802,신촌전철역,4493,1447,5940,37.5553901125,126.9371485343
13803,금화장오거리,50,641,691,37.5644864668,126.9593378205
13804,동명여중,21,73,94,37.5680640191,126.9629186057
13805,차고앞,5,261,266,37.5915705415,126.9351293826
13808,고은초교삼거리,0,21,21,37.5842616936,126.9436845024
13813,영천시장입구,131,169,300,37.5684809789,126.9619594904
13814,홍은중학교,0,353,353,37.5926714357,126.9347015063
13816,정원여중입구,118,76,194,37.5865602152,126.9346366412
13818,명진아트빌라,17,298,315,37.5829135972,126.943546249
13819,문화공원입구,22,53,75,37.5942912091,126.9484966108
13820,가재울초등학교,37,77,114,37.5745622293,126.9183585228
13821,연대앞.세브란스병원,823,1206,2029,37.5602943607,126.9355917024
13822,미성아파트,20,570,590,37.5936545113,126.9346802635
13823,남가좌동아이파크후문,254,331,585,37.5745040424,126.9206142993
13824,싸이버아파트,1,121,122,37.5872194803,126.9340393252
13826,동신병원사거리,85,75,160,37.5815669075,126.9356034175
13827,동성교회,5,85,90,37.5941402463,126.9494683467
13828,연희성당,298,528,826,37.5630514409,126.9311005456
13830,남가좌동아이파크정문,243,197,440,37.5749489217,126.9215738878
13831,동원빌라,7,101,108,37.5871586938,126.9333033629
13832,홍은2동주민센터,26,44,70,37.5809086238,126.934715178
13833,오동나무,1,92,93,37.593009015,126.9507351582
13834,연희브라운스톤,335,1142,1477,37.5657082519,126.9302298489
13835,3호선독립문역,32,133,165,37.5724599224,126.9584504401
13837,삼성그린빌,199,509,708,37.5868978487,126.9325460681
13838,서대문내품애센터,48,113,161,37.5803213337,126.9334962806
13839,금강빌라.인왕중학교,5,169,174,37.5922107348,126.9516257391
13840,하나은행연희동지점,270,545,815,37.5669938067,126.931247474
13841,이진아기념도서관,5,186,191,37.5727088538,126.9565857109
13844,서대문문화체육회관,8,211,219,37.5815354767,126.9318571973
13845,버드나무가게,0,19,19,37.590994104,126.9527510089
13846,종근당후문,128,152,280,37.5594697141,126.9637436891
13847,사러가쇼핑,100,96,196,37.5672110495,126.9303732956
13848,국민은행,95,235,330,37.5677564703,126.9318331689
13849,극동아파트119동,244,441,685,37.5729676798,126.9547526626
13850,사천교,214,62,276,37.5683166376,126.9185424288
13852,팔각정,0,29,29,37.583313833,126.9303357066
13853,삼거리연탄.약수터입구,1,10,11,37.5904725788,126.9532665726
13855,민속식당,22,33,55,37.5679615197,126.9296164448
13857,이진아기념도서관,160,3,163,37.5726421343,126.9564804632
13858,유진상가,434,145,579,37.591660052,126.9426778859
13859,명지고후문,0,51,51,37.5841656006,126.9292207427
13860,개미마을,6,22,28,37.5897135968,126.9537786344
13861,아현전철역,129,41,170,37.5574907123,126.9577230295
13862,서연중학교,9,64,73,37.5691422348,126.928589688
13864,3호선독립문역,137,22,159,37.5724049323,126.9583836762
13865,이대입구,49,359,408,37.5568998934,126.9452863295
13866,백련사,5,74,79,37.5849059393,126.9286278498
13867,평화교회,9,54,63,37.5695046821,126.9260014418
13869,극동아파트입구,148,26,174,37.5719201973,126.9585322513
13870,신촌아트레온,35,226,261,37.5564894962,126.9407252016
13871,북아현동주민센터,118,130,248,37.5596417843,126.9567766726
13874,삼호아파트.천연동주민센터,186,30,216,37.5707914279,126.9593909971
13875,홍은초등학교.간호대입구,185,361,546,37.5968134349,126.9483983653
13876,경남아파트.북아현119안전센터,17,311,328,37.5607808911,126.9560391181
13877,서서울농협홍은지점.동신병원,4,408,412,37.5800385838,126.9354666025
13878,영천시장입구,155,63,218,37.5689547887,126.9614410169
13879,간호대정문,27,160,187,37.5973129248,126.9471326
13880,중앙여고,115,198,313,37.5620580263,126.9549530248
13881,중앙여고,25,704,729,37.562450459,126.9556170486
13882,홍은2동어린이집앞,1,236,237,37.5795467759,126.9341740353
13883,감리신학대학교,44,37,81,37.5679216001,126.9625724585
13885,추계초등학교,129,395,524,37.5636952525,126.9542624655
13886,두산아파트,7,91,98,37.5787201694,126.9320428222
13887,서대문센트레빌,72,87,159,37.5671723156,126.9639357971
13888,포방시장,103,587,690,37.5993508468,126.9485644718
13891,홍은2동주민센터,392,16,408,37.5804137793,126.9344518005
13892,광산사우나,39,141,180,37.5656108726,126.9644312366
13893,포방공영주차장,15,412,427,37.6008595246,126.9491591491
13894,힐스테이트신촌.신촌푸르지오1단지후문,8,582,590,37.5608966456,126.9515497876
13895,인창중고,12,95,107,37.5647326205,126.9641139341
13897,호박골다리,22,231,253,37.5981372208,126.9468857242
13898,초원약국,7,467,474,37.5598106586,126.9498696017
13902,홍은동국민주택,0,13,13,37.6051967755,126.9499071147
13905,풍림.극동아파트,5,932,937,37.6034755286,126.9495050706
13907,홍은동국민주택,2,11,13,37.6056464425,126.949965709
13911,홍제역.3번출구,4448,2820,7268,37.5884321956,126.9442328155
13912,홍제우체국,487,336,823,37.5867611042,126.9463325749
13913,홍제2동주민센터,41,0,41,37.5861855115,126.949649234
13915,인왕산현대아파트입구,25,17,42,37.5854477501,126.9479674436
13916,삼호아파트.천연동주민센터,19,221,240,37.570506964,126.9600087407
13917,홍제역.1번출구,2300,736,3036,37.5890349366,126.944047791
13918,유진상가.인왕시장,730,237,967,37.5907884605,126.9421882308
13919,연희브라운스톤,655,237,892,37.5660497076,126.9301310454
13922,신촌기차역,919,661,1580,37.5587257522,126.9426327429
13923,인왕산현대아파트입구,23,29,52,37.5851813121,126.9487531269
13924,인왕산현대아파트117동,1,88,89,37.5863067328,126.9510210022
13926,북아현로입구,2469,383,2852,37.5581795882,126.9564549195
13927,인왕산현대아파트117동,47,1,48,37.5864158661,126.9510203195
13928,이대전철역,48,297,345,37.5569744833,126.9468188341
13929,유진상가,1028,1508,2536,37.5906566603,126.9419373753
13930,인왕산현대아파트101동,1,86,87,37.5861227688,126.9504373685
13933,홍은2동주민센터,75,11,86,37.5801955537,126.9341610096
13934,뜨란채아파트101동,115,1,116,37.5659098551,126.958513127
13935,뜨란채아파트101동,371,835,1206,37.5657892,126.958626211
13936,홍지문35통,37,9,46,37.5967940402,126.9561380553
13937,옥천교앞,39,9,48,37.5963608926,126.9543661773
13938,대명빌라,14,72,86,37.5729270056,126.9270218704
13939,인왕시장,27,9,36,37.591139002,126.942912416
13940,창덕에버빌,97,76,173,37.5693943762,126.91742748
13941,영천동,43,173,216,37.5701370515,126.9605988267
13942,독립문,40,85,125,37.5714816578,126.9593725088
13943,영천동,96,29,125,37.5700627813,126.960381957
13944,동원베네스트아파트입구,37,2,39,37.5982578813,126.9447652539
13945,홍은유원아파트입구,142,17,159,37.5972309406,126.9451708339
13946,동원베네스트주차장.두산위브입구,348,400,748,37.5991156733,126.9442149137
13947,홍은사회복지관별관,35,35,70,37.5941280566,126.9474377485
13952,서강아파트1차정문앞,159,67,226,37.5949183961,126.934065371
13953,연희상가아파트,5,27,32,37.5731224341,126.928044361
13955,봉원사입구,457,370,827,37.5667306356,126.9464269727
13956,증산역.증산2교,294,3,297,37.5837069844,126.9113530601
13957,행운부동산앞,2,44,46,37.5809892128,126.916578396
13958,은가경로당앞,2,68,70,37.5810400985,126.9179580379
13959,삼성유치원.씨유앞,4,95,99,37.5815105244,126.9185042381
13960,두란노어린이집앞,11,106,117,37.5815815396,126.9207840836
13961,은혜감사어린이집,3,46,49,37.5820455097,126.9224798172
13962,백련어린이공원.공영주차장,1,30,31,37.5826610496,126.9236989303
13963,상록운수,4,6,10,37.5840282682,126.9233580202
13964,명지대학교교회,66,36,102,37.5825812067,126.9253633984
13965,명지대후문.세븐일레븐,12,1,13,37.5814681556,126.9248522221
13966,백련어린이공원,23,3,26,37.5822559752,126.9239938349
13967,은혜감사어린이집앞,56,18,74,37.5820882288,126.9223608986
13968,두란노어린이집,56,10,66,37.5817423785,126.9205272051
13969,삼성유치원앞.씨유,71,8,79,37.581739926,126.9184796033
13971,행운부동산앞,27,6,33,37.5808266426,126.9165576051
13972,북가좌사거리,8,13,21,37.5815349216,126.9137827727
13973,북가좌오거리,6,17,23,37.5811559999,126.9124960014
13974,북가좌2동주민센터,28,16,44,37.5813659825,126.9111737609
13975,해담는다리앞,27,48,75,37.5822276439,126.9093836158
13976,이마트24앞,52,12,64,37.5819344759,126.9214779936
13977,증산2교,34,259,293,37.5839069226,126.9109326449
13978,홍제천입구,2,92,94,37.5788352473,126.9321466162
14001,마포역,4159,4062,8221,37.5409425139,126.9479644874
14002,마포역,3062,2747,5809,37.540277175,126.9467854312
14003,공덕역,1557,1862,3419,37.5436049054,126.9509046196
14004,공덕역,1694,1666,3360,37.5445016819,126.9513544428
14005,아현동주민센터,1386,1021,2407,37.546364876,126.9529070766
14006,아현동주민센터,991,1248,2239,37.5470777755,126.9532416189
14007,마포경찰서,1610,1101,2711,37.5501999331,126.9552123486
14008,마포경찰서,1410,1345,2755,37.5507703612,126.9553048134
14009,아현초등학교,947,771,1718,37.5540780443,126.9571001865
14010,아현초등학교,1110,1065,2175,37.5548981253,126.9573351399
14011,합정역,1917,4298,6215,37.5489993779,126.9129885095
14012,합정역,4598,1107,5705,37.5495322937,126.9138559699
14013,서교동,2371,2709,5080,37.5536367406,126.9195815796
14014,서교동,2361,2137,4498,37.554149067,126.920047245
14015,홍대입구역,10891,6915,17806,37.5566403375,126.9234653018
14016,홍대입구역,5037,7747,12784,37.5573256439,126.9243162516
14061,동교동삼거리,3867,4511,8378,37.558067095,126.928542674
14062,신촌오거리.현대백화점,2676,3691,6367,37.5553966479,126.9358930618
14063,신촌오거리.2호선신촌역,1435,1694,3129,37.5561071246,126.940153403
14064,이대역,3297,2674,5971,37.5566543493,126.9444960625
14065,광명21세기병원,334,466,800,,
14066,광명21세기병원,317,430,747,,
14067,웨딩타운,2062,1615,3677,37.557092,126.951517
14068,아현역,2448,1468,3916,37.5572940008,126.9549417458
14095,모세로삼거리.광명시보훈회관,117,151,268,,
14096,모세로삼거리.광명시보훈회관,174,1809,1983,37.5552260552,126.9218643721
14097,홍대입구역,108,2446,2554,37.5586515499,126.9259252365
14098,합정역,26,1254,1280,37.547751,126.910155
14099,합정역,1,458,459,37.5514613841,126.9161214841
14100,아현동가구단지,680,620,1300,37.5579672892,126.9606652753
14101,마포구청.성산자동차검사소,923,1247,2170,37.5649538546,126.9024231067
14102,마포구청,1354,823,2177,37.5649023958,126.9018904171
14103,마포농수산물시장.월드컵공원,598,469,1067,37.5661067292,126.8974542618
14104,월드컵경기장남측.월드컵공원,732,787,1519,37.5666679881,126.8963261593
14105,월드컵경기장서측.문화비축기지,325,329,654,37.569236499,126.895467768
14106,월드컵경기장서측.문화비축기지,299,339,638,37.5694982692,126.8949636335
14107,월드컵파크3단지.난지천공원,32,307,339,37.5733547348,126.8879570409
14108,월드컵파크3단지.난지천공원,375,62,437,37.5723190695,126.8884623272
14109,서부면허시험장,91,326,417,37.5778826192,126.880437164
14110,서부면허시험장,357,46,403,37.5775610281,126.8803980947
14111,DMC첨단산업센터,1118,829,1947,37.5853442979,126.8851878625
14112,DMC첨단산업센터,776,1297,2073,37.585598,126.884787
14115,월드컵공원입구.문화비축기지,76,240,316,37.568523,126.892748
14116,월드컵파크3단지정문,356,470,826,37.573822,126.889228
14117,월드컵파크2단지.에스플렉스센터,573,609,1182,37.575267,126.890647
14118,월드컵파크2단지.에스플렉스센터,640,578,1218,37.5753384971,126.8902909609
14119,합정역,640,595,1235,37.5485905004,126.9143006049
14120,합정역,322,487,809,37.5487970862,126.9146251811
14121,서울화력발전소입구,305,235,540,37.5481890927,126.9175061586
14122,서울화력발전소입구,258,297,555,37.5479367436,126.9174453228
14123,상수역,220,267,487,37.5476829367,126.9216470319
14124,상수역,246,201,447,37.5478737711,126.9215637852
14125,서강초등학교,27,33,60,37.5478027651,126.9253669692
14126,서강초등학교,24,53,77,37.5474910871,126.9261941009
14127,광흥창역,65,50,115,37.5476090642,126.9305409732
14128,광흥창역,28,46,74,37.5473522775,126.9305842172
14129,광흥창역,63,323,386,37.5473123228,126.9339394067
14130,마포세무서,76,75,151,37.5469713032,126.9390917397
14132,마포역,817,545,1362,37.5397090071,126.9457368286
14134,공덕역10번출구,39,362,401,37.5419401801,126.9528746311
14135,안터마을입구,469,81,550,37.5417232771,126.9528901577
14141,공덕역.공덕시장,847,1608,2455,37.5444134861,126.9530314936
14142,공덕시장,1519,713,2232,37.544351852,126.9541479054
14143,신덕성결교회,374,441,815,37.5459410072,126.9566906448
14144,신덕성결교회,322,556,878,37.5458923284,126.9561622385
14145,한겨레신문사,1140,604,1744,37.548146748,126.9588159115
14146,광성초등학교.철산도서관.철산3동주민센터,1018,1129,2147,37.5479971758,126.9589872289
14149,공덕역6번출구,461,606,1067,37.5430732748,126.9531626402
14150,공덕역7번출구,721,460,1181,37.5427512615,126.9533323949
14151,용마루고개.신공덕삼성아파트,219,439,658,37.541871,126.955885
14152,하안2동주민센터.하안주공1.2.3.4단지,776,1093,1869,37.542444957,126.9507441044
14153,하안2동주민센터.하안주공1.2.3.4단지,1045,304,1349,37.5434939017,126.951631774
14154,도화동현대아파트,151,193,344,37.5403322186,126.9557014553
14155,도화동현대아파트,109,259,368,37.5405429216,126.955832541
14156,중동초등학교,159,669,828,37.5668726108,126.9104194588
14157,중동초등학교,520,131,651,37.5666220223,126.9103076889
14158,성산2동주민센터,1390,655,2045,37.5677928213,126.9083263491
14159,성산2동주민센터,331,1289,1620,37.5680037628,126.9084370307
14160,성산119안전센터,463,848,1311,37.5698617774,126.9038566649
14161,성산119안전센터,1511,517,2028,37.569712828,126.9037125673
14162,하안4동주민센터.하안주공4.10단지,486,649,1135,37.571597138,126.9014985417
14163,하안4동주민센터.하안주공4.10단지,856,497,1353,37.5714611354,126.9014134049
14164,DMC상암센트럴파크,348,972,1320,37.5751843905,126.896039836
14165,DMC상암센트럴파크,693,272,965,37.5751546184,126.8954851821
14166,상암초등학교,1239,432,1671,37.5763917144,126.8934221518
14167,상암초등학교,658,1577,2235,37.5765495834,126.8937200609
14168,신촌로터리,620,473,1093,37.5538094529,126.9368825067
14169,신촌로터리,558,1373,1931,37.5535240112,126.9372675673
14170,서강대학교,771,648,1419,37.5511,126.93797
14171,서강대학교,647,755,1402,37.5518272757,126.9373153932
14172,광성중고등학교,877,952,1829,37.5493548145,126.9386715493
14173,광성중고등학교,994,805,1799,37.548952,126.93986
14174,대흥역,471,670,1141,37.5481067455,126.9409887457
14175,대흥역,1214,815,2029,37.5476750559,126.9427204259
14176,용강초등학교,732,691,1423,37.546977106,126.9435145128
14177,동도중학교.서울디자인고등학교,1019,951,1970,37.5464778856,126.945401461
14178,동도중학교.서울디자인고등학교,1102,997,2099,37.5456406475,126.9467666745
14179,공덕역2번출구,1491,1218,2709,37.5451999014,126.9483406072
14180,공덕역1번출구,958,1289,2247,37.5444323434,126.9493208487
14181,서서울농협홍대역점,221,407,628,37.556592,126.91971
14182,동교로사거리,530,385,915,37.5558462446,126.9209476216
14184,성산동,85,176,261,37.564768944,126.9069033254
14185,하안사거리.7단지,1468,575,2043,37.564522802,126.9122332335
14186,성산2교,280,746,1026,37.5638632409,126.9132054677
14187,하안사거리.7단지,585,1160,1745,37.5617966139,126.9151050102
14188,오리서원.충현중학교.광휘고등학교,826,429,1255,37.5624635723,126.9140662478
14189,경성중고.홍대부속여중고입구,164,66,230,37.560551806,126.9158070869
14190,경성중고.홍대부속여중고입구,846,359,1205,37.5596512854,126.9166140242
14191,경성중고.홍대부속여중고입구,167,462,629,37.5594093604,126.9172809899
14192,하안3동주민센터.하안주공7.8단지,462,578,1040,37.5572277306,126.9193196292
14193,충현중학교.광휘고등학교.오리서원,972,598,1570,37.5578790449,126.9182029073
14194,마포구청역,1646,338,1984,37.5627277529,126.902662558
14195,마포구청역,444,1739,2183,37.5624588168,126.9024722199
14196,하안3동주민센터.하안주공7.8단지,675,561,1236,37.5636762812,126.9067285152
14197,마포중앙도서관,350,492,842,37.564253,126.907457
14198,성산2교,776,692,1468,37.56566824,126.9135548771
14199,성산2교,666,977,1643,37.5656929458,126.9126441333
14200,광흥창역.서강동주민센터,600,1928,2528,37.5482784766,126.9319142889
14201,광흥창역.서강동주민센터,1944,520,2464,37.548254678,126.931412223
14202,창전현대홈타운,295,515,810,37.5508818035,126.9326546465
14203,창전현대홈타운,573,518,1091,37.5507124982,126.932199547
14204,신촌로터리,1180,399,1579,37.5538899564,126.9345617
14205,신촌로터리,289,1130,1419,37.5540511998,126.9356825619
14207,이대역6번출구,688,363,1051,37.5564896634,126.9447874756
14208,이화여대입구,625,156,781,37.5559161044,126.9457318695
14209,이대역5번출구,83,437,520,37.5557990945,126.946020578
14210,대흥교회,447,439,886,37.5540499504,126.9457581231
14211,대흥교회,313,342,655,37.5537887705,126.9460582466
14212,서강대후문.마포아트센터,593,781,1374,37.5504951872,126.9439464603
14213,마포자이2차아파트.대흥역,101,280,381,37.548758,126.942535
14215,굴레방다리.아현역,322,95,417,37.5571518068,126.9574606253
14216,양화진성지공원입구,44,507,551,37.5486575374,126.9122481343
14218,홀트아동복지회,1823,296,2119,37.5490106533,126.9121780839
14219,합정역,986,418,1404,37.5510604429,126.9156095164
14220,합정역,468,996,1464,37.5502177028,126.9153071515
14224,홍대입구역,2606,900,3506,37.5565612263,126.9230438058
14225,홍대입구역,0,10,10,37.556651825,126.923813304
14226,연남동,3356,2780,6136,37.5625221708,126.9275410215
14228,신촌역,1473,1369,2842,37.555637521,126.9347610004
14230,극동방송,365,146,511,37.5494237971,126.9231511533
14231,극동방송,100,231,331,37.5494290547,126.9229225322
14232,홍익대학교,331,174,505,37.5521905815,126.923804758
14233,홍익대학교,506,819,1325,37.5530705865,126.924641406
14234,산울림소극장,277,207,484,37.5543703111,126.9298077585
14235,산울림소극장,264,467,731,37.554958166,126.9301572482
14236,신수중학교,113,88,201,37.545242206,126.9326481273
14237,신수중학교,90,96,186,37.5454360008,126.9327520694
14238,래미안웰스트림아파트,166,143,309,37.5442313666,126.9362364705
14239,한국출판콘텐츠센터,256,98,354,37.5446547963,126.9354090177
14240,용강동주민센터,201,132,333,37.5419177341,126.9404187472
14241,용강동주민센터,265,286,551,37.5417099622,126.9411793777
14242,용강동입구,105,71,176,37.5396325539,126.9441050979
14244,메세나폴리스,894,345,1239,37.5509477452,126.9129324905
14245,마포한강푸르지오,494,1199,1693,37.550787,126.912592
14246,성산초등학교입구,319,439,758,37.5531302266,126.9118676593
14247,성산초등학교입구,148,306,454,37.553218,126.912262
14248,기업은행서교동지점,292,528,820,37.5547915422,126.9114638988
14249,기업은행서교동지점,499,226,725,37.5548695099,126.9108956213
14250,망원시장.망원동월드컵시장입구,747,571,1318,37.5573371725,126.9087601732
14251,망원시장.망원동월드컵시장입구,543,760,1303,37.5575911259,126.9089432755
14252,마포구청역입구,213,411,624,37.5604275533,126.906364689
14253,마포구청역입구,582,267,849,37.5605946475,126.9057249395
14254,성서초등학교,198,73,271,37.5588032368,126.9114976368
14255,성서초등학교,61,142,203,37.5585137421,126.9111731244
14256,새서울의원,162,714,876,37.5510938111,126.9072376566
14257,미원아파트입구,135,85,220,37.5591229348,126.9032162229
14258,미원아파트입구,62,86,148,37.5591653733,126.9033225674
14259,망원2동주민센터,78,91,169,37.5600059068,126.9030950972
14260,망원2동주민센터,141,61,202,37.5600805608,126.9029286079
14261,청기와빌라,114,63,177,37.560782282,126.9043928297
14262,청기와빌라,43,113,156,37.5607605683,126.9047512686
14263,망원정입구,273,58,331,37.5525939414,126.9069935902
14264,성산초등학교,55,31,86,37.553593858,126.9100992042
14265,서서울농협,123,278,401,37.553553121,126.906062842
14266,서서울농협,307,94,401,37.5534086494,126.9060056297
14267,망원1동주민센터,425,138,563,37.5556235492,126.9048936302
14268,망원1동주민센터,165,289,454,37.5554407976,126.9051055187
14269,동교초등학교,177,220,397,37.557946251,126.90421537
14270,동교초등학교,236,157,393,37.5578909496,126.9040871071
14271,월드컵파크7단지,571,1231,1802,37.5811497135,126.8784199476
14272,월드컵파크7단지,932,902,1834,37.581876,126.878963
14273,월드컵경기장북측,141,181,322,37.5728554605,126.8994695568
14274,월드컵경기장북측,120,424,544,37.573967,126.898104
14275,경성중고.홍대부속여중고입구,28,141,169,37.5597317011,126.9156529372
14283,삼진제약,309,665,974,37.5533537628,126.9267223052
14284,홍대입구역사거리,767,261,1028,37.5547384096,126.9222053762
14286,상암DMC홍보관.YTN,1356,2433,3789,37.577985,126.891323
14287,상암DMC홍보관.YTN,3407,1672,5079,37.5774605863,126.8912875667
14288,월드컵파크5단지.상암중고등학교입구,1438,1849,3287,37.580921,126.886335
14289,월드컵파크5단지,1887,1254,3141,37.5803332786,126.8865178403
14290,구룡근린공원,317,176,493,37.5834310105,126.8826124496
14291,상암고등학교,1394,1178,2572,37.5819239214,126.8841995172
14292,월드컵파크3단지후문,71,251,322,37.571242,126.889762
14293,서강대후문.마포아트센터,1046,421,1467,37.54982788,126.943770647
14295,월드컵파크4단지후문.JTBC,611,249,860,37.5773614776,126.8898953585
14296,디지털미디어시티역2번출구,4218,1272,5490,37.5752078233,126.8996741287
14305,하안1동주민센터,536,91,627,,
14306,월드컵파크4단지후문.JTBC,224,351,575,37.577857071,126.889945572
14307,누리꿈스퀘어.MBC,1082,2296,3378,37.578988,126.889637
14308,밤일마을입구,45,97,142,37.5450734893,126.9234283579
14309,범안사거리,41,44,85,37.5448091234,126.924290977
14310,한강밤섬자이아파트,64,16,80,37.5457358405,126.9277926676
14311,한강밤섬자이아파트,49,39,88,37.5455492751,126.9277294722
14312,서강해모로아파트,16,17,33,37.5456864091,126.9294970623
14313,서강해모로아파트,14,16,30,37.5454945461,126.9296149399
14314,서교동주민센터.마포신문사,482,478,960,37.5548915242,126.9163533449
14315,동교로사거리,334,77,411,37.5556445461,126.91982843
14316,월드컵경기장북측,67,72,139,37.5737580172,126.8979917064
14317,강변한신코아,239,313,552,37.5374403051,126.9439785202
14328,광명차고지,188,1,189,,
14330,난지한강공원,3,21,24,37.5680089232,126.8781937234
14331,난지한강공원,17,10,27,37.5687642494,126.8750873208
14332,월드컵공원입구.문화비축기지,47,115,162,37.568177,126.892749
14333,디지털미디어시티역,31,125,156,37.5750780768,126.9007548894
14334,월드컵파크9.10.11.12단지,77,635,712,37.58533,126.878833
14335,월드컵파크9.10.11.12단지,1950,231,2181,37.5843953147,126.8799671809
14336,용마루고개.브라운스톤공덕아파트,89,228,317,37.541133045,126.9568297914
14337,하늘초등학교,83,806,889,37.585322,126.879658
14338,월드컵파크10단지,35,465,500,37.5862054537,126.881348387
14339,월드컵파크11.12단지,802,66,868,37.5862704288,126.8808993224
14340,수색교,230,20,250,37.5872149306,126.8839820122
14341,수색교,14,155,169,37.5870817539,126.8839598515
14342,가좌역1번출구,270,174,444,37.5683159216,126.9149412588
14343,가좌역,138,150,288,37.5678973956,126.9153689271
14344,디지털미디어시티역,156,207,363,37.5755263424,126.9007797653
14346,청구아파트.참누리아파트,45,105,150,37.5742321541,126.9028581629
14347,청구아파트.참누리아파트,119,147,266,37.5738331722,126.9031032213
14348,중동현대아파트,249,178,427,37.5716856118,126.9072675947
14349,중동현대아파트,247,261,508,37.5714636428,126.9072883544
14350,가좌행복주택.건영월드컵아파트,165,164,329,37.5694513482,126.9121016153
14351,가좌행복주택.건영월드컵아파트,157,208,365,37.5693048881,126.9120367007
14352,월드컵아이파크,108,41,149,37.5667337059,126.9136074112
14353,월드컵아이파크,24,93,117,37.5664713538,126.9136846815
14354,DMC첨단산업센터,14,372,386,37.5840594436,126.8865456046
14355,DMC첨단산업센터,627,30,657,37.5836187524,126.886622684
14356,SBS.YTN,41,511,552,37.579829791,126.8943776781
14357,SBS.YTN,454,472,926,37.5798316679,126.8939587977
14358,공항철도디지털미디어시티역,1759,341,2100,37.5766983835,126.8990065446
14359,공항철도디지털미디어시티역,892,2519,3411,37.5769634812,126.8981967646
14360,디지털미디어시티역,253,715,968,37.5753552366,126.900584183
14361,상암동주민센터앞,154,88,242,37.578461396,126.8939275345
14362,MBC,29,554,583,37.5820834608,126.8907318462
14363,MBC,1051,144,1195,37.5818267278,126.8907859977
14442,양지사거리.체육공원,6,27,33,,
14490,난지천공원.박정희대통령기념관,1,58,59,37.5744127596,126.8861728907
14491,공덕시장,1195,228,1423,37.5443868565,126.9541672852
14492,마포16번종점,122,9,131,37.5608656017,126.8988594191
14493,서부면허시험장.월드컵파크8단지,852,18,870,37.5785320093,126.882110569
14494,창전중앙하이츠아파트,75,104,179,37.549919204,126.92752631
14495,망원유수지.마포구민체육센터,791,216,1007,37.5564968722,126.8985925441
14496,양화진성지,45,9,54,37.5456403732,126.9119307997
14497,홍대입구역,3105,1981,5086,37.5573254742,126.9236679158
14498,홍대입구역,704,446,1150,37.5577282744,126.9234387243
14499,아현전철역,1340,555,1895,37.5571368168,126.9562461927
14500,샛별문방구.마포전철역,259,408,667,37.5398243005,126.947628807
14501,청암대,0,100,100,37.5357415195,126.9477362472
14502,한겨레신문사,107,328,435,37.5471556001,126.9589794255
14503,동원데자뷰아파트,51,1,52,37.5603378705,126.8992212168
14505,창전삼성아파트109동,46,1,47,37.5502446123,126.9302782196
14506,홍대후문,53,0,53,37.5512061281,126.927367497
14507,신촌수정탕,51,54,105,37.5497981454,126.9375706084
14508,태양빌딩,416,6,422,37.55611,126.899382
14509,난지천공원,15,8,23,37.5740883789,126.8860527171
14510,다운교회,16,0,16,37.5456250178,126.9128255229
14511,동교로사거리,631,158,789,37.5557913332,126.9210303052
14512,코오롱아파트106동앞,7,48,55,37.5609091091,126.9231008719
14513,가든호텔.삼성프라자,315,149,464,37.5407448359,126.9492092871
14514,우성아파트3동,117,30,147,37.5361648924,126.9475068947
14515,대상아파트,84,0,84,37.5597426063,126.8996419598
14517,창전삼성아파트107동,28,0,28,37.5507316247,126.9309953149
14518,서강유치원,20,0,20,37.5519120695,126.9279949601
14519,삼익아파트입구,22,27,49,37.5499070227,126.9356035042
14520,용약국,168,10,178,37.554479102,126.9368472568
14521,월드컵파크3단지,14,17,31,37.5726253056,126.8883543312
14522,한이맨션,26,0,26,37.54551586,126.9141581354
14524,코오롱아파트104동앞,19,81,100,37.5622933508,126.9219754172
14525,돼지슈퍼,52,30,82,37.556961,126.961677
14526,형제식당,15,123,138,37.557353,126.961069
14527,하나님의교회,50,127,177,37.5462180095,126.9598793339
14528,신부파스카아파트,138,2,140,37.5587574153,126.9003563794
14530,창전삼성아파트104동,19,0,19,37.5510770869,126.9315846569
14531,육완순무용원,24,0,24,37.5527354367,126.9290988156
14532,신수경남아파트,33,36,69,37.5500104497,126.9336171589
14534,성원아파트,377,111,488,37.556576,126.901603
14536,서일빌딩,34,2,36,37.5454162494,126.9159825506
14537,청원빌딩,68,287,355,37.5584151692,126.9181649687
14538,코오롱아파트사거리,34,121,155,37.5630345645,126.9213939451
14539,신일약국,41,383,424,37.5560100579,126.9625987905
14540,아현실버복지관,77,28,105,37.5576412633,126.9602156344
14541,S마트,60,130,190,37.547055,126.943554
14542,동교초등학교,61,11,72,37.5572273703,126.9014438887
14544,창전삼성아파트입구,4,7,11,37.5516299322,126.9324080979
14545,와우공원입구,5,5,10,37.5531811274,126.9300208249
14546,마포소방서,52,26,78,37.5490808985,126.9326944706
14547,광흥창역.서강동주민센터,99,44,143,37.5483004315,126.9326343365
14548,대흥역,564,101,665,37.5480716446,126.9410725222
14549,동교초등학교,349,9,358,37.5568114132,126.9029520908
14550,마포농수산물시장.월드컵경기장,68,116,184,37.5660689383,126.8972675665
14551,마포새빛문화숲,49,0,49,37.5452896463,126.9179054483
14552,경성고교입구,147,407,554,37.5601111815,126.9166359308
14553,대룡빌딩,69,116,185,37.5636821303,126.9222716786
14554,공덕역입구,397,230,627,37.542036376,126.9515801113
14555,성원아파트,86,357,443,37.556736,126.901586
14556,한강공원입구,2,439,441,37.556266,126.899256
14557,금호태영아파트,141,259,400,37.5537200783,126.9317248509
14558,경의선책거리.산울림소극장,8,9,17,37.5549249512,126.9303700659
14559,신수동성당.신수동주민센터,68,78,146,37.5472604384,126.9338504704
14560,서강수협.신수중학교,122,135,257,37.5453150473,126.9323900344
14561,용강초등학교,153,66,219,37.54705602,126.9435526305
14562,망원동사거리,302,44,346,37.55714,126.904322
14563,마포구청.마포구청역,361,266,627,37.5657503917,126.9009458973
14564,마포새빛문화숲후문,19,1,20,37.5450286612,126.9210360015
14565,마포FM,65,338,403,37.5609964881,126.9177138986
14566,연남동주민센터,64,129,193,37.5640863415,126.9230681745
14567,도화현대1차아파트111동앞,10,42,52,37.5411751362,126.9543656256
14569,성원아파트,34,69,103,37.5471721489,126.9371834845
14570,한국출판콘텐츠센터,170,132,302,37.5446957205,126.9353844685
14571,서울여자중고등학교,103,176,279,37.547055382,126.9471495554
14572,망원시장,366,92,458,37.557492,126.905979
14573,월드컵경기장역,236,54,290,37.5692704064,126.9002903006
14574,상수동,59,14,73,37.5464906666,126.9230500467
14575,경성중고.홍익디자인고,91,336,427,37.5619139666,126.9192591331
14576,에덴지우아파트,92,107,199,37.5645907957,126.924217758
14577,도화현대1차아파트,7,66,73,37.5404825999,126.9554309077
14579,망원유수지.마포구민체육센터,272,10,282,37.55588,126.899167
14582,마포세무서,52,43,95,37.5470162832,126.9389468423
14583,신수현대아파트.래미안웰스트림,195,174,369,37.5437179924,126.9367020261
14584,염리삼성아파트,159,224,383,37.5484856059,126.9475661602
14585,구)망원우체국사거리,202,360,562,37.557824975,126.9076978449
14586,상수역,66,33,99,37.5476371966,126.9235904983
14587,코오롱아파트사거리,108,274,382,37.5636983072,126.9208510308
14588,비뉴,77,39,116,37.5639839246,126.9249462367
14589,서부수도사업소,8,42,50,37.556804829,126.9598728435
14590,화평교회,273,18,291,37.5544373457,126.9011589449
14591,신촌역,149,240,389,37.5556204253,126.9348062895
14592,굴다리시장,33,53,86,37.5462786361,126.9414168429
14593,신석초등학교,339,192,531,37.543163949,126.9386568825
14594,일성여자중고등학교,180,462,642,37.5488734491,126.9484113079
14595,망원전철역,519,911,1430,37.556111,126.909936
14596,상수두산아파트,88,5,93,37.5475467474,126.9244409921
14597,경성중고후문,16,151,167,37.5643791604,126.9202967687
14598,하모니마트사거리,40,34,74,37.5633660552,126.9253883256
14599,만물사부동산,55,166,221,37.5553480504,126.9607372268
14600,하나님의교회,3,22,25,37.539331855,126.9553127738
14601,MBC,21,731,752,37.5796281217,126.8917373023
14602,월드컵파크4단지,4,92,96,37.5778014837,126.8877410517
14603,상암중학교,2,118,120,37.5789717535,126.8872438991
14604,서울산업진흥원.국악방송,4,149,153,37.5807370662,126.8889507316
14605,우리기술사옥.한국지역정보개발원,5,194,199,37.5822609838,126.887878597
14606,DMC빌,1,56,57,37.5823926492,126.8855908513
14607,우리금융상암센터.DMC빌,96,0,96,37.581932163,126.885575198
14608,도화현대1차아파트단지내,193,673,866,37.5397829588,126.9545930351
14610,상암고등학교,1,116,117,37.5809780136,126.8825326891
14611,상암월드컵파크6.7단지,13,36,49,37.5812734756,126.8805398078
14612,상암월드컵파크6.7단지,146,1,147,37.5810587094,126.8806237964
14613,상암고등학교,65,1,66,37.580684598,126.8836707859
14616,월드컵파크6단지상가,76,4,80,37.5798067452,126.885663889
14617,공덕역10번출구,394,291,685,37.5418479155,126.9530953371
14618,공덕역10번출구,816,141,957,37.5418343172,126.952886013
14619,웨딩타운,102,108,210,37.5569705649,126.951583453
14620,상지초등학교,0,93,93,37.5797209678,126.8814543536
14622,아현전철역,23,39,62,37.557174107,126.9568346839
14623,스탠포드호텔,33,1,34,37.5825593088,126.8865648633
14624,우리기술사옥.한국지역정보개발원,147,2,149,37.582026762,126.8878117007
14625,전자회관,132,1,133,37.5808056835,126.8886559163
14626,상암중학교,27,0,27,37.579330494,126.8872133447
14627,월드컵파크6단지,36,6,42,37.5781786312,126.8873113833
14628,YTN뉴스퀘어.씨제이이앤엠,455,10,465,37.579007,126.891577
14659,마포한강아이파크아파트,203,21,224,37.5524231339,126.9041144875
14661,중동초등학교,147,91,238,37.566822815,126.9101093439
14662,대흥태영아파트,36,55,91,37.5457513998,126.9430638871
14663,용강동주민센터,97,113,210,37.5418828151,126.9405579807
14667,마포현대아파트,169,285,454,37.5487755518,126.9491538042
14669,성산초등학교,101,59,160,37.5542263109,126.9123428704
14670,서강초등학교,104,8,112,37.5474902299,126.9262642691
14671,경의선숲길공원입구,34,193,227,37.5658939505,126.9190510756
14672,대명아파트,51,21,72,37.5624505717,126.9243116542
14674,환일고등학교,48,122,170,37.5545623235,126.9608191314
14675,용산성당.현대홈타운,99,645,744,37.5376063241,126.9531660599
14676,가구단지,37,44,81,37.5580233931,126.9607211084
14677,하모니마트,162,29,191,37.5522804732,126.9059979922
14678,성모병원사거리,207,123,330,37.564613951,126.9121224136
14693,창전삼성아파트입구,2,11,13,37.5517786762,126.9325188796
14694,대흥세양아파트,10,46,56,37.5448456877,126.9447270314
14700,아현1동경로당,30,71,101,37.5536056568,126.9610258398
14712,마포전철역,117,806,923,37.539618346,126.9445498324
14713,공덕삼성3차아파트후문,276,216,492,37.5491526058,126.9512380153
14714,고니빌딩,123,103,226,37.5545141067,126.9140402901
14715,서강쌍용아파트.광흥창역,108,58,166,37.5479459242,126.9302871512
14716,사천고가앞,11,122,133,37.613647,127.074999
14718,원효초등학교,22,90,112,37.536212316,126.9509196507
14727,새서울의원,390,87,477,37.5512595136,126.9070201173
14738,창전삼성아파트104동,0,11,11,37.5512824672,126.9314899516
14742,와우산로오거리,18,2,20,37.5544423161,126.9299639616
14744,마포자이아파트,13,37,50,37.5441046793,126.9460097727
14745,성지빌딩,138,165,303,37.5414733719,126.945776289
14746,엘지빌딩,166,162,328,37.5487892486,126.95342782
14747,서교동주민센터,123,146,269,37.5547403269,126.9153507025
14748,이랜드,92,20,112,37.5491991774,126.9315365761
14749,만리동고개,240,312,552,37.5516189178,126.9622625784
14750,한강타운.우성아파트16동앞,121,160,281,37.5359386921,126.949516699
14753,공덕전철역,319,408,727,37.5432839409,126.9526849444
14754,남경장,80,234,314,37.5487583715,126.9098198111
14755,창전삼성아파트107동,0,5,5,37.5508496218,126.9309159814
14756,와우공원입구,0,22,22,37.5532611124,126.9299420833
14757,염리초등학교,110,102,212,37.542602893,126.9467600134
14758,염리초등학교,176,112,288,37.5426264908,126.9471368388
14760,아현동주민센터,204,186,390,37.5471182709,126.9531057864
14761,우리은행서교동지점,130,274,404,37.5532594418,126.9173477744
14763,마포노인복지관,14,32,46,37.5495294243,126.9323103997
14764,공덕동주민센터,167,91,258,37.5505203493,126.960089214
14765,청암대,97,55,152,37.5358265963,126.9478810865
14799,성서초등학교,494,203,697,37.5586625923,126.9126081977
14804,창전어린이공원,0,5,5,37.5502765745,126.9295120239
14805,창전어린이공원,9,0,9,37.5501638696,126.9292518497
14808,창전삼성아파트109동,1,15,16,37.5504041647,126.9303622842
14809,육완순무용원,3,49,52,37.5528551348,126.9290569126
14810,중부여성발전센터,73,80,153,37.541218067,126.9451382306
14812,재화스퀘어,46,19,65,37.543896028,126.9468982901
14814,공덕전철역,158,331,489,37.545520682,126.9510176651
14832,홍대입구역사거리,217,293,510,37.5545259524,126.9209776106
14833,창전현대홈타운,19,22,41,37.5508740938,126.9327234162
14834,삼우빌딩,59,47,106,37.5492115356,126.9579450038
14835,합정역,235,1082,1317,37.5498487849,126.9147926148
14836,희성교회,159,80,239,37.5568038157,126.914080671
14837,서강유치원,0,62,62,37.5520413218,126.9279627818
14838,마포전철역,520,79,599,37.5396209172,126.9442691905
14839,한국컴퓨터,59,25,84,37.5449286853,126.94493407
14842,신촌연세병원.기업은행,83,278,361,37.5519917333,126.9332204035
14843,공덕동성당,147,69,216,37.5483812312,126.9568867015
14844,우리은행서교동지점,51,99,150,37.5519430729,126.9175337114
14845,서교동주민센터.마포신문사,21,47,68,37.5548725266,126.9162481047
14846,홍대후문,2,73,75,37.5513088608,126.9273099469
14848,대흥태영아파트,77,27,104,37.545951456,126.943090896
14849,동도중학교.서울디지인고등학교,247,153,400,37.5464463948,126.9455044702
14851,서울서부지방법원,25,39,64,37.5487999972,126.955348589
14852,세븐일레븐,24,49,73,37.5404068073,126.9559961557
14853,동교로사거리,1,74,75,37.5556580917,126.919871426
14855,신석초등학교,213,362,575,37.5434232109,126.9388467265
14856,굴다리시장,45,43,88,37.5463896176,126.9417132655
14858,서교동주민센터,158,123,281,37.5555997561,126.9150520526
14862,서교푸르지오아파트,177,177,354,37.5536272738,126.9231791726
14863,홍대입구역,833,559,1392,37.5566897307,126.9232162658
14864,신수현대아파트.래미안웰스트림,248,174,422,37.5438334622,126.9369441072
14865,마포세무서,46,49,95,37.5472983739,126.939039414
14866,대흥역사거리,188,86,274,37.5481047003,126.9423208067
14867,신촌역,1491,820,2311,37.5553244188,126.9356327981
14869,마포경찰서,65,106,171,37.5503384443,126.9553278673
14870,도화현대1차아파트111동앞,7,25,32,37.5412403149,126.9545638633
14871,홍대정문,127,176,303,37.5529817959,126.9238877068
14872,동교로사거리,45,38,83,37.555868873,126.91976141
14873,한국출판콘텐츠센터,167,103,270,37.5447473219,126.9355502266
14874,신수세양아파트,55,38,93,37.5474092121,126.9373247519
14876,서교동교회,81,165,246,37.5516621838,126.9192022864
14877,애오개역,59,102,161,37.5525946358,126.9565340004
14878,공덕역입구,139,43,182,37.5422234996,126.9516244161
14879,로데오거리,315,236,551,37.5508193618,126.9214305434
14880,서교동주민센터.마포신문사,40,49,89,37.5550661861,126.9161414944
14881,서강수협.신수중학교,162,110,272,37.5454755063,126.932501928
14882,신수동성당.신수동주민센터,28,43,71,37.5474825845,126.934706995
14883,숭문중고등학교후문,12,58,70,37.5520916812,126.9453441712
14884,로데오거리,161,199,360,37.5506427579,126.9214465737
14886,가든호텔.삼성프라자,139,105,244,37.540742839,126.9490519166
14887,희성교회,125,190,315,37.556871554,126.9142956492
14888,광흥창역.서강동주민센터,138,206,344,37.5479365863,126.9328324399
14889,마포프레스티지자이아파트,183,311,494,37.5534760955,126.9460686583
14890,홍대정문,119,161,280,37.5520039556,126.9236510232
14892,아현초등학교,17,98,115,37.555836965,126.9558084037
14893,샛별문방구.마포전철역,382,169,551,37.5400571192,126.947597365
14894,상지초등학교,6,6,12,37.5795651804,126.8813928881
14895,합정역,1217,128,1345,37.5505859949,126.9149513563
14896,성서초등학교,337,285,622,37.5586852894,126.9128379471
14897,마포소방서,37,116,153,37.5504232028,126.9331168737
14898,이대전철역,21,556,577,37.5559135339,126.9460216273
14899,홍대정문,228,430,658,37.5531509051,126.9248314705
14900,라사라패션직업전문학교,94,127,221,37.5541278747,126.929511747
14901,사천고가앞,212,34,246,37.566914654,126.9174119301
14902,S마트,44,59,103,37.538833948,126.947453957
14905,경성중고사거리,324,169,493,37.5606439736,126.9161669371
14906,서교푸르지오아파트,113,91,204,37.5539101296,126.9231795079
14907,경의선숲길공원입구,219,26,245,37.5654631791,126.9191849347
14908,우성아파트입구,63,77,140,37.5379689566,126.9473838471
14910,성미약수터,96,183,279,37.5622973046,126.9146652433
14913,경성중고후문,118,40,158,37.5644362483,126.9201211423
14914,우성아파트3동,8,173,181,37.536403474,126.9473962615
14915,하모니마트,37,314,351,37.5525211624,126.9061199251
14916,성모병원사거리,172,244,416,37.5646439871,126.9125264992
14917,코오롱아파트사거리,251,70,321,37.5635807867,126.9208407845
14918,도화현대1차아파트,39,32,71,37.5404537169,126.9553041828
14919,마포한강아이파크아파트,12,323,335,37.5526385439,126.9041741974
14920,중동초등학교,109,180,289,37.5665745631,126.9107016888
14921,신한은행서교동금융센터점,207,124,331,37.5573853501,126.9183539873
14922,경성중고.홍익디자인고,264,100,364,37.5622871811,126.919496441
14923,망원파출소.롯데장학관,29,403,432,37.5536897719,126.9026460189
14924,대우미래사랑아파트,94,60,154,37.5567410028,126.9169681476
14925,효성약국,444,67,511,37.5612082417,126.917709138
14926,화평교회,18,289,307,37.554615888,126.9013092437
14927,성산시영아파트,229,335,564,37.5699733715,126.9036833144
14928,한국해양전략연구소,64,51,115,37.55615891,126.9157158214
14929,망원파출소.롯데장학관,378,12,390,37.5534558318,126.9027470741
14930,망원유수지.마포구민체육센터,17,306,323,37.5559856164,126.8992531113
14932,서교동주민센터,118,37,155,37.5556453918,126.9146083137
14933,창전삼성아파트,10,20,30,37.5515831433,126.9325269785
14934,임오빌딩,163,75,238,37.5587705681,126.917399414
14935,월드컵경기장역,22,67,89,37.573873297,126.8983131242
14936,새화빌딩,28,71,99,37.5551110975,126.9134453847
14937,신촌이랜드청년주택,56,98,154,37.5495116343,126.9315214065
14940,성산초등학교,76,193,269,37.5544197369,126.9119272598
14941,우리은행서교동지점,89,63,152,37.5533631842,126.9175609269
14942,서강쌍용아파트.광흥창역,55,83,138,37.547971961,126.93012642
14943,동교로사거리,10,406,416,37.5560597174,126.9210453635
14944,동교초등학교,13,123,136,37.557089657,126.901628566
14946,망원전철역,1102,433,1535,37.556114,126.910258
14947,서교동주민센터,153,132,285,37.5556503792,126.9152772343
14948,서강초등학교,3,97,100,37.547746198,126.9263556875
14950,신부파스카아파트,2,120,122,37.5587854475,126.900472928
14951,KBS미디어센터,28,114,142,37.5762495025,126.8912678163
14952,구)망원우체국사거리,106,316,422,37.557933,126.907297
14953,홍대후문,14,182,196,37.5477681308,126.9254084029
14954,대상아파트,1,87,88,37.5596562821,126.8998548757
14955,월드컵파크2단지.에스플렉스센터,13,43,56,37.5752557916,126.8903116509
14956,망원동월드컵시장,91,333,424,37.5576257556,126.9059890137
14957,상수역,35,134,169,37.5478391735,126.9223888577
14958,동원데자뷰아파트,0,80,80,37.560265953,126.8994205325
14959,망원동사거리,17,263,280,37.557387,126.904716
14960,로데오거리,15,122,137,37.5479257309,126.9205037113
14961,마포16번종점,11,85,96,37.5609278604,126.8989566813
14962,서부면허시험장.월드컵파크8단지,14,717,731,37.5782548127,126.8819694963
14963,동교초등학교,2,261,263,37.5570015474,126.9029563717
14964,합정동,8,76,84,37.5476074126,126.9181201992
14965,마포새빛문화숲,0,32,32,37.5455098635,126.9171164107
14966,서일빌딩,0,37,37,37.5455541032,126.9159631569
14968,성우맨션,2,49,51,37.5456357722,126.9142496659
14969,다운교회,0,30,30,37.5457365309,126.9127953093
14971,월드컵경기장역,149,185,334,37.569515608,126.9001461683
14972,마포구청.마포구청역,79,225,304,37.5663307977,126.899575309
14976,우성아파트입구,159,61,220,37.537980068,126.9475018046
14977,망원교회,344,89,433,37.55623509,126.9001616621
14978,망원교회,112,296,408,37.5564958163,126.9005291712
14979,신촌역,590,296,886,37.5546992456,126.9359751517
14981,경성중고사거리,121,258,379,37.5606202414,126.915740226
14982,삼진제약,314,258,572,37.5532074175,126.92682996
14983,한국영화아카데미,185,213,398,37.5542981382,126.9294391491
14984,서교동교회,278,110,388,37.5517506356,126.9194138368
14985,성산2동주민센터,216,363,579,37.5680244492,126.9083871955
14987,월드컵파크7단지,17,25,42,37.5804105731,126.8798688581
14988,창전삼성아파트110동,81,125,206,37.5499354757,126.9283523987
14989,신촌역,1505,1046,2551,37.5542870566,126.9358956814
14990,신촌역,502,145,647,37.5544909027,126.9356255921
14991,신촌농협.하나로마트,106,476,582,37.5561881182,126.9332008127
14992,기업은행.신촌연세병원,676,430,1106,37.5531660102,126.9334875964
14993,세븐일레븐,51,76,127,37.5401511395,126.9559382398
14994,아현고개,110,94,204,37.5566204258,126.9469798113
14996,백합아파트,96,3,99,37.5579505185,126.9009301902
14997,백합아파트,1,139,140,37.557938922,126.9010705599
15101,홍익병원목동관,747,1944,2691,37.5309083865,126.8640300339
15102,금호어울림.대원칸타빌아파트,254,350,604,37.5326907306,126.8665441384
15103,목동3단지후문,291,785,1076,37.5343243418,126.8699099401
15104,영도초등학교,372,336,708,37.5355559091,126.8705188382
15105,신목중학교.목동2단지후문,255,196,451,37.5381652606,126.8735523348
15106,목동2단지,1645,1373,3018,37.5365999339,126.8779874254
15107,목동3단지,574,852,1426,37.534747,126.875742
15108,목동4단지상가.목동종합운동장,1381,1290,2671,37.5322979868,126.8751149732
15109,목동3.4단지사잇길,668,208,876,37.5327958586,126.8719802822
15111,목동사거리,1726,1883,3609,37.5332695189,126.8638355299
15112,영도중.강서고입구.기아양서대리점,1811,1425,3236,37.5361735073,126.8636220426
15113,목동시장.대일고교.배광교회,1196,1198,2394,37.5390050043,126.863840943
15114,신목중학교,507,378,885,37.5371228212,126.8718965121
15115,목동스카이아파트.목동3단지,1306,383,1689,37.534287789,126.86961025
15116,금호어울림.대원칸타빌아파트,190,267,457,37.5328780454,126.8668605943
15117,신목동역2번출구,117,526,643,37.5438547597,126.8823418211
15118,신목동역1번출구,278,31,309,37.5439220697,126.882068981
15119,경서농협,428,376,804,37.521363,126.856298
15126,목동성원아파트,1556,1052,2608,37.5422950368,126.8631752063
15127,목3동주민센터.현대아이파크.실로암안과,2194,1702,3896,37.5448325228,126.8624010187
15128,등촌역6번출구.목동깨비시장,1511,2196,3707,37.5496948079,126.8639369391
15140,월촌초등학교,246,139,385,37.5411875533,126.8770703252
15141,월촌초등학교.우성아파트,169,206,375,37.5405030314,126.8753672844
15142,목원초등학교.서울지방식품의약품안전청,88,224,312,37.5425325465,126.8811364216
15143,용왕산,35,56,91,37.5391300565,126.874232426
15144,신목동역,122,128,250,37.5459435557,126.881497679
15145,목동한신청구아파트,222,202,424,37.5406383625,126.8801650973
15146,목동한신청구아파트,305,160,465,37.5407286601,126.8803505399
15147,목동1.2단지사잇길,43,69,112,37.5383884014,126.8784758339
15148,월촌중학교.목동1단지,2155,3218,5373,37.5379123848,126.8816710436
15149,목동YMCA.서울에너지공사,26,61,87,37.5388422797,126.8826597565
15150,목동YMCA.서울에너지공사,163,146,309,37.5390353122,126.8828573282
15151,목동5단지C상가.목동운동장북문,1150,1120,2270,37.5328197258,126.8774929435
15152,파리공원,1038,1250,2288,37.5346216632,126.8783257944
15153,목동5단지B상가.목5동주민센터,2174,1556,3730,37.5357698917,126.8813067124
15154,목동이대병원.목동6단지앞,2892,1778,4670,37.53684743,126.8844278116
15155,목동아파트601동앞.이대병원,118,466,584,37.5358926776,126.8832527876
15156,목동5.6단지사잇길.경인초교,174,759,933,37.5328700866,126.883850411
15157,오목교역,292,1090,1382,37.5250698135,126.8763828695
15158,양정고등학교,306,36,342,37.5352231619,126.8879022224
15159,목1동주민센터.양천소방서,311,407,718,37.529802,126.87358
15160,목동역3번출구.홍익병원,4653,1417,6070,37.5273814301,126.8644323939
15161,CBS방송국,264,570,834,37.5280972176,126.8741491329
15162,목운초등학교.목운중학교,169,376,545,37.5264186976,126.873770474
15163,목동7단지,444,734,1178,37.5285096907,126.8702312245
15164,목운초등학교.목운중학교,2215,1826,4041,37.5261261893,126.8733948469
15165,목동운동장남문.아이스링크,1030,1110,2140,37.5284743808,126.8765922255
15166,목동7단지.종로학원,1737,1163,2900,37.5256721661,126.8687626438
15167,오목교역1번출구.대학빌딩,3047,2604,5651,37.524957,126.873313
15168,오목교역.동신한방병원,1170,1340,2510,37.524448727,126.8768222179
15169,갈산초등학교정문,397,522,919,37.5128049409,126.8704857561
15170,오목교역.청학스포츠타운,27,512,539,37.5234268996,126.8754466022
15171,새마을금고,399,439,838,37.5210696367,126.8736392011
15172,신정2동주민센터,601,273,874,37.5189830043,126.8714242396
15173,오목교역.동신한방병원,1526,1097,2623,37.5240854759,126.8769218981
15174,신목초등학교입구,432,316,748,37.517471,126.870927
15175,목동14단지상가,397,319,716,37.514708147,126.8718895902
15176,현대아파트정문,27,69,96,37.5197850505,126.8774210833
15177,현대아파트정문,39,27,66,37.5207879158,126.8782362614
15178,삼성아파트정문,72,142,214,37.516349522,126.8769040606
15179,삼성아파트후문,19,115,134,37.518115032,126.8771500437
15180,현대아파트후문,13,47,60,37.5219304431,126.8781721806
15181,목동14단지C상가앞,280,469,749,37.5140461143,126.8741755588
15182,목일중학교,206,74,280,37.5140188189,126.8739267611
15183,목동13단지,74,52,126,37.5142684329,126.8693990705
15184,목동14단지,50,61,111,37.5147422125,126.8695819439
15185,신트리공원,52,344,396,37.5144890648,126.8579171135
15186,목동12.13단지사잇길,70,191,261,37.5130539408,126.8635453462
15187,목동12.13단지사잇길,177,83,260,37.5132321011,126.8632703412
15188,신목초등학교입구,81,450,531,37.5173017573,126.8707856913
15189,목동14단지관리사무소앞,247,403,650,37.5151432295,126.8722112168
15190,목동11단지,104,92,196,37.5132198855,126.858308657
15191,목동14단지관리사무소앞,32,46,78,37.5147961876,126.8716908326
15192,양천구청역,821,285,1106,37.5125666892,126.865327879
15193,양천공원,590,643,1233,37.517872,126.869642
15194,양천구청,966,575,1541,37.516543,126.86703
15195,양천구민체육센터.양천일자리센터,702,335,1037,37.5155435776,126.8642387934
15196,목동12단지,864,559,1423,37.5141819623,126.8603283424
15197,갈산초등학교정문,383,371,754,37.5128276097,126.8701085117
15198,갈산초등학교후문,209,150,359,37.5110893778,126.8687090062
15199,갈산초등학교후문,108,306,414,37.5112881566,126.8692119822
15200,은정초등학교,120,491,611,37.51032353,126.8667027318
15201,은정초등학교,401,98,499,37.5100942816,126.8671059902
15202,목동우성아파트,399,517,916,37.5071981739,126.8657101781
15203,목동우성아파트입구,1138,495,1633,37.5084511066,126.8642093283
15204,양천아파트,366,638,1004,37.5081742559,126.8633494936
15205,봉영여중.목동고,539,284,823,37.5072813126,126.861841071
15206,봉영여중.목동고,175,305,480,37.5073907618,126.8614268774
15207,봉영여중.목동고,63,189,252,37.5086342212,126.8618162875
15208,양천노인종합복지관,164,55,219,37.5102877693,126.8591784815
15209,양천구청역,711,787,1498,37.5128696347,126.8666090852
15210,양천아파트,238,82,320,37.510264,126.862762
15211,신정네거리해누리분수광장,1847,853,2700,37.5218864223,126.8515143857
15212,신정네거리.신정119안전센터,451,1336,1787,37.5220233018,126.8507300915
15213,동방아파트,392,963,1355,37.5218824877,126.8463249183
15214,동방아파트.신월종합사회복지관,1116,659,1775,37.5214264859,126.8462896508
15215,신곡시장.금빛새마을금고,254,1452,1706,37.5196434749,126.8437433353
15216,신곡시장.금빛새마을금고,1129,337,1466,37.5192849388,126.8438198804
15217,신한은행신월동지점,885,1175,2060,37.5180186395,126.8416025861
15218,신한은행신월동지점,1690,683,2373,37.5178279621,126.8418635354
15219,양강중학교,630,1559,2189,37.5237110271,126.8499936
15220,신월2동주민센터입구,2272,383,2655,37.5227588172,126.845690477
15221,강서초등학교.신월4동주민센터,1933,311,2244,37.5218776213,126.8419309679
15222,한빛종합사회복지관,1455,297,1752,37.5212558706,126.8392498206
15223,신월동남부주유소,400,474,874,37.5193930878,126.8385850656
15224,신월2동우체국,464,462,926,37.523082,126.851248
15225,신트리사거리,347,343,690,37.5131152074,126.855949147
15226,신트리아파트,1430,297,1727,37.5129013233,126.854140221
15227,정랑고개.양천벤처타운,836,259,1095,37.5115773183,126.8503821304
15228,신정학마을아파트,632,1067,1699,37.5074208503,126.8439634217
15229,양천고등학교,1645,187,1832,37.5099267313,126.8456571614
15230,계남초등학교,226,184,410,37.50975303,126.8584301705
15231,목동아파트11단지,641,406,1047,37.5073061738,126.8599070047
15232,신정1동주민센터.신오새마을금고,223,597,820,37.5172033635,126.8543710811
15233,양명초교.신서중,410,365,775,37.5143052592,126.855702514
15234,신트리공원.목동아파트11단지,216,83,299,37.5139204866,126.8571828958
15235,목동10단지상가,517,460,977,37.5159691889,126.8596768178
15236,양천문화회관.양천일자리센터,643,982,1625,37.5169332443,126.8623809974
15237,목동10단지농협,39,74,113,37.5178010215,126.8563817008
15238,목동13단지,56,71,127,37.5145138464,126.8692996703
15239,목동13단지,17,143,160,37.5135267044,126.8680275029
15241,신서초등학교,21,107,128,37.5206410194,126.8618413297
15242,신정1동우체국,353,267,620,37.521953,126.861673
15247,우리은행신정동지점,542,461,1003,37.521705,126.859385
15248,목동프라자,41,82,123,37.5198759498,126.8602781332
15249,목동10단지,75,198,273,37.5190869699,126.8566524982
15250,신정네거리역,974,1175,2149,37.5210387184,126.8534032338
15251,신정네거리역,1097,1227,2324,37.5194642102,126.8533978302
15252,길훈로즈빌아파트,251,207,458,37.5224330208,126.8711569767
15253,미래탐구초중학원.종로학원,842,796,1638,37.5248101641,126.8694004931
15254,목동역5번출구,1160,1611,2771,37.5257967805,126.8654053381
15255,목동8단지지하도,112,45,157,37.5200478423,126.8669116745
15256,양천구청.양천보건소,757,1665,2422,37.5181625662,126.8661628949
15257,목동8단지.한전,678,704,1382,37.5201834629,126.8683291544
15258,진명여고,1174,1986,3160,37.5239401081,126.8651037893
15259,서울남부지방법원.서울남부지방검찰청,741,541,1282,37.52179,126.865547
15260,서울남부지방법원.서울남부지방검찰청,379,932,1311,37.5218496017,126.8659323028
15261,오목교역.청학스포츠타운,1502,501,2003,37.5236278346,126.8753149721
15262,현대아이파크아파트,224,419,643,37.5210340842,126.873256871
15263,목동중학교.서울출입국.외국인청,98,388,486,37.5198771646,126.8708457351
15264,오목교역8번출구.대학빌딩,919,1290,2209,37.524726482,126.8728637695
15265,목동7단지,983,1422,2405,37.5255869926,126.867125263
15266,제일은행앞,17,66,83,37.5193001008,126.8640996248
15268,서울남부지방법원.서울남부지방검찰청,448,243,691,37.5221940523,126.8633685313
15269,신정2동주민센터.목동중학교,635,284,919,37.5190605632,126.8703493965
15270,목동역7번출구.진명여고,2839,1185,4024,37.5245071942,126.8645744119
15271,우리은행신정동지점,585,379,964,37.5219011411,126.8587126514
15272,목동역8번출구.목동오거리,1091,740,1831,37.5258057871,126.8631068968
15273,신서고등학교.영상고등학교입구,948,655,1603,37.5253957175,126.8599725442
15274,신정역.신정4동주민센터,956,3897,4853,37.5246301301,126.8542989447
15277,신정1동우체국,171,317,488,37.5221525641,126.8614154182
15279,서울남부지방법원.서울남부지방검찰청,383,381,764,37.5225339507,126.8643534946
15280,신정네거리역,1080,590,1670,37.5212769715,126.853432075
15281,신서고등학교.영상고등학교앞,65,70,135,37.5226250743,126.8594494182
15282,목동제일여성병원,798,735,1533,37.5224739148,126.8518789155
15283,신정4동경서농협,260,440,700,37.52151618,126.8551726588
15284,목동역.홍익병원,1051,2730,3781,37.5280495538,126.8639151684
15285,목동역.목동오거리,2202,1628,3830,37.5259586072,126.8627909553
15286,신서고교.영상고교입구,737,759,1496,37.5256530348,126.8603986015
15287,신정역.신정4동주민센터,3302,954,4256,37.5248637099,126.8539719864
15288,양강중학교,761,546,1307,37.5250671294,126.8505530267
15292,신월문화체육센터,790,76,866,37.519969,126.835249
15293,신월동우성상가,1718,194,1912,37.5217809008,126.8338259542
15294,중부운수앞,44,118,162,37.5241040725,126.8307797604
15295,신월문화체육센터,139,866,1005,37.5201173667,126.8362023324
15296,신월동우성상가,406,1523,1929,37.5217175664,126.8339903939
15298,국립과학수사연구소입구,887,627,1514,37.5223552552,126.8370345521
15299,신안파크아파트후문,152,54,206,37.5239255582,126.8288364619
15300,신안파크아파트후문,2,235,237,37.5240984718,126.8289139798
15301,국립과학수사연구소.고강동종점,756,44,800,37.5234552209,126.8257794501
15302,신정1동주민센터.신오새마을금고,579,308,887,37.5176031829,126.8538761936
15303,신정네거리역,1458,878,2336,37.5198533776,126.8528216878
15304,신트리아파트,536,1463,1999,37.5130325951,126.8538683824
15305,정랑고개.양천벤처타운,158,775,933,37.5116613527,126.8498548282
15306,서부트럭터미널.신정동일하이빌아파트,729,454,1183,37.510935,126.842363
15307,강신중학교,584,611,1195,37.5152713231,126.8403598507
15308,남명초교.신정3동주민센터,131,417,548,37.515076534,126.8549125537
15309,금옥중.금옥여고.백암고등학교,198,1416,1614,37.5098523335,126.8445827103
15310,양강중학교,416,926,1342,37.524862,126.85028
15311,양강중학교,409,1285,1694,37.5238498474,126.8495049505
15312,신월2동주민센터입구.경창전통시장,364,1722,2086,37.5231005832,126.8460404234
15313,강서초등학교.신월4동주민센터,425,1687,2112,37.522025949,126.8416789569
15314,한빛종합사회복지관,223,857,1080,37.521341727,126.8387477223
15315,과학수사연구소입구,761,942,1703,37.5219046542,126.8369620025
15316,서부트럭터미널.신정동일하이빌아파트,529,583,1112,37.5100886262,126.8423997674
15317,신정현대아파트.서부트럭터미널,1055,401,1456,37.5083597993,126.8429841108
15318,넓은들공원,97,80,177,37.5107961068,126.8392002136
15319,넓은들공원,75,76,151,37.5110656513,126.838645415
15320,신정현대아파트,1183,236,1419,37.5087818233,126.842139551
15321,신정숲속마을아파트,234,207,441,37.5064470434,126.8341353536
15322,신정숲속마을아파트.댓골마을입구,141,194,335,37.506763681,126.8356122927
15323,푸른마을2단지아파트,929,196,1125,37.5141912766,126.8340906245
15324,푸른마을2단지아파트,34,758,792,37.514032,126.833988
15325,신월시영아파트.강월초등학교,570,136,706,37.515731,126.83553
15326,신월시영아파트.강월초등학교,173,812,985,37.515937,126.835305
15327,강월초교사거리,358,114,472,37.516359946,126.8377839139
15328,강월초교사거리,127,429,556,37.5166925531,126.8378578575
15329,금실어린이공원,197,331,528,37.5179542888,126.8377738585
15330,금실어린이공원,122,211,333,37.5174285164,126.8378532017
15331,강신중학교,639,375,1014,37.5158628238,126.839808639
15332,양서중학교,586,545,1131,37.5315463481,126.8309503372
15333,신월1동주민센터.신월보건지소,843,822,1665,37.5321812684,126.8310479701
15334,신월3동주민센터.신월3동우체국,966,863,1829,37.5346648231,126.8288288926
15335,서부여성발전센터,569,794,1363,37.535164296,126.8290121927
15336,가로공원공영주차장.신영시장,521,108,629,37.5363759851,126.8330270198
15337,신월사거리.국민은행신월동지점,1313,73,1386,37.5358050015,126.8291078692
15338,서서울호수공원,682,592,1274,37.5290347298,126.8325721561
15339,서서울호수공원,758,935,1693,37.5292505864,126.8329212932
15340,하나은행신월동지점,0,252,252,37.5304768462,126.8379926774
15341,가로공원공영주차장,87,500,587,37.5366508061,126.8325796723
15342,양원초교.광영여고,257,171,428,37.5390246021,126.8235071834
15343,국민은행신월동지점,160,763,923,37.5362149282,126.8296038629
15344,메디힐병원,499,896,1395,37.5369926272,126.8277768675
15345,신화중학교,183,684,867,37.5396509921,126.8313535928
15346,신월5동주민센터.신월중학교,622,659,1281,37.5394783937,126.8275323805
15347,신월5동주민센터.신월중학교,1225,619,1844,37.539249826,126.8276175857
15348,신월중학교입구,578,191,769,37.539901203,126.8252825465
15349,신월중학교입구,328,490,818,37.540131513,126.8256582331
15350,광영고.신동아파밀리에아파트,78,77,155,37.5393577897,126.8233615523
15351,서울금융고등학교,565,445,1010,37.537320428,126.8270247465
15352,신화중학교,865,361,1226,37.53935507,126.8307630563
15353,경창빌딩,310,401,711,37.5186593622,126.8385824561
15354,신월시영아파트중문,427,382,809,37.519095445,126.8367192546
15355,신월시영아파트중문,243,178,421,37.5190839909,126.8365807096
15356,목원초등학교.서울지방식품의약품안전청,55,78,133,37.5430365015,126.8813545994
15357,양천노인종합복지관,60,117,177,37.5104115391,126.8590792819
15358,양서중학교,93,87,180,37.5327964612,126.8302430927
15359,양명초등학교,21,34,55,37.5160834014,126.8572418295
15360,신목동역.서울지방식품의약품안전청,551,212,763,37.5436358,126.8833582818
15361,목동파라곤,1020,1015,2035,37.5300691011,126.8755214922
15362,신정현대아파트.서부트럭터미널,524,1036,1560,37.5090108927,126.8420065648
15363,대일관광고.푸른마을3단지,222,234,456,37.5111781699,126.836221887
15364,대일관광고.푸른마을3단지,127,288,415,37.511319,126.835885
15365,신정현대아파트,0,32,32,37.5086365863,126.8410741599
15366,신월문화체육센터,47,29,76,37.5205124893,126.8368773634
15367,목동아파트1102동앞,128,85,213,37.5115795698,126.8601148427
15368,트럭터미널주유소앞,20,2,22,37.5090877674,126.8415437621
15369,목동아파트1434동앞,730,286,1016,37.5156610604,126.8719841075
15370,목동아파트1216동앞,41,144,185,37.5115054211,126.8621876648
15372,목동아파트1218동앞,19,69,88,37.5117167505,126.8636210262
15373,양천공영차고지,1,1497,1498,37.5084237826,126.8372401516
15374,국립과학수사연구소.고강동종점,7,699,706,37.5236309481,126.8259331584
15377,신월동기점,151,0,151,37.529576762,126.8386621156
15378,양천공영차고지,358,52,410,37.5087014007,126.8376467183
15399,푸른마을1단지.이든채아파트,863,266,1129,37.5126531126,126.8353881275
15401,신정교입구,98,180,278,37.5186052595,126.8739017041
15402,중부운수앞,11,144,155,37.5242203138,126.8307794978
15405,서남병원.이든채아파트,98,214,312,37.512878,126.83488
15408,신정교입구,882,230,1112,37.5185708053,126.8736165136
15412,계남초등학교,194,369,563,37.5101238882,126.8577593241
15413,신목동역.서울지방식품의약품안전청,139,287,426,37.5436432794,126.8835304104
15414,보람쉬움아파트,447,206,653,37.5297998782,126.8354825562
15415,보람쉬움아파트.신영시장,265,327,592,37.5299044382,126.8352416009
15416,신정이펜하우스2단지,145,297,442,37.5145028936,126.8305420682
15419,이펜하우스1단지.어르신요양센터,234,314,548,37.5133944288,126.8288196516
15421,신정이펜하우스3.4단지,600,376,976,37.5112884496,126.8304616781
15423,신정이펜하우스5단지.서남병원,333,171,504,37.511195872,126.8334705173
15450,원종IC,0,2,2,,
15451,고강지하차도입구,0,13,13,,
15452,고강지하차도입구,0,1,1,,
15453,원종IC,0,3,3,,
15500,푸른마을아파트3단지,95,18,113,37.5120789765,126.8365884562
15501,강서보건소.9호선등촌역,2356,1391,3747,37.5490380694,126.8680475339
15503,목2동주민센터,1455,256,1711,37.5461773017,126.8713802897
15504,동일하이빌아파트,37,50,87,37.5100140206,126.8408155962
15505,팔복부동산.목동교회,360,527,887,37.543894503,126.870383328
15506,신정현대아파트.서부트럭터미널,121,161,282,37.5084268815,126.8412612427
15507,목동문화체육센터.건영아파트,401,1102,1503,37.5417556164,126.8690347158
15508,한성교회.금옥여고.백암고,386,93,479,37.5107847678,126.8430650004
15509,우신웨스트빌.목동보건지소,426,673,1099,37.5394632318,126.8690375939
15510,대림.수정아파트,228,29,257,37.5123383373,126.8424429811
15511,벽산.대주아파트,237,32,269,37.5143898216,126.8415302899
15512,성원.극동아파트,194,183,377,37.5380036179,126.8716473252
15513,목동센트럴2단지,79,24,103,37.515529943,126.8410312611
15516,목동센트럴1단지,58,65,123,37.5164268831,126.8407068265
15518,농협.영도초등학교,350,153,503,37.535918184,126.8705498954
15522,학마을2단지아파트,21,280,301,37.5088381976,126.8442805344
15524,한신청구아파트,98,75,173,37.53969003,126.8815754738
15526,학마을2단지아파트,338,11,349,37.5089601172,126.8440958579
15536,신정1동주민센터,181,71,252,37.5183653861,126.8547129441
15539,목동10단지,145,67,212,37.5189371319,126.8566246544
15540,오목교역.대학학원,1227,459,1686,37.5248106495,126.8741567243
15542,목동프라자,215,133,348,37.5193999936,126.8593705814
15545,신서초교,123,48,171,37.5206350924,126.8621671623
15547,서울남부지법,64,36,100,37.5216813177,126.8629843287
15553,한신청구아파트정문,26,126,152,37.5398180274,126.8816171411
15554,목동8단지천주교,95,205,300,37.5225981211,126.8688815376
15556,목동3.4단지사잇길,182,599,781,37.5327979786,126.8716438006
15561,용왕산입구,67,130,197,37.5380880949,126.8731057989
15564,성원.극동아파트,450,344,794,37.5380073723,126.8717853725
15565,목동9단지B상가,88,112,200,37.5182652653,126.860685007
15566,현대아파트.월드메르디앙아파트,579,283,862,37.5390523984,126.8699130421
15567,목동프라자,98,71,169,37.5195079433,126.8592176522
15568,우신웨스트빌.목동보건지소,656,407,1063,37.5402388202,126.8688076498
15570,목동문화체육센터.건영아파트,1073,348,1421,37.5418504119,126.869197507
15571,신정1동주민센터,103,164,267,37.5184090452,126.8543800508
15572,팔복부동산.목동교회,217,650,867,37.5438486739,126.8704988384
15574,목2동주민센터,182,1677,1859,37.5466952437,126.8713325179
15576,양동중학교,65,238,303,37.547522312,126.8687518796
15577,수명산입구,398,397,795,37.5434136288,126.8288756598
15579,거산아파트,83,27,110,37.5401966583,126.8319712047
15582,신곡시장,45,117,162,37.5187453383,126.842581104
15584,목동센트럴1단지,57,173,230,37.5165519359,126.8404713803
15585,목동센트럴2단지.이마트24,41,164,205,37.5157451286,126.8408152558
15586,벽산.대주아파트,49,285,334,37.5145607856,126.8413477998
15587,대림.수정아파트,42,199,241,37.5122985653,126.8423503064
15588,한성교회.백암고,75,153,228,37.5111080859,126.8429319752
15589,금옥여고.대우미래사랑아파트,74,154,228,37.5096646181,126.8436826965
15591,동일하이빌아파트,19,57,76,37.5101435591,126.8406524331
15593,현대아파트.월드메르디앙아파트,302,360,662,37.5387122738,126.8703583513
15594,롯데캐슬아파트.목3동시장,464,567,1031,37.5480700593,126.8670352013
15596,신정이펜하우스1단지,94,2,96,37.5150602232,126.8280891009
15599,서남병원,122,4,126,37.5117397462,126.8325983835
15600,신은초등학교,111,6,117,37.5133381042,126.8335392789
15614,신은초등학교,4,157,161,37.5134441509,126.8336662919
15635,서남병원,17,180,197,37.5117570005,126.83252592
15637,이펜하우스3.4단지,0,95,95,37.5120485294,126.8295805468
15638,양천어르신요양센터,0,56,56,37.5134418624,126.828910031
15639,신정이펜하우스1단지.새금성교회,3,105,108,37.5144526403,126.8284976952
15718,양천공영차고지,1207,41,1248,37.5084115031,126.8374184549
15992,강서양천교육지원청,138,12,150,37.541566,126.829937
15995,거산아파트,6,123,129,37.5407169042,126.8316906449
16001,염창역.서울도시가스,4545,2339,6884,37.547146203,126.8758965674
16002,염창역.서울도시가스,1917,3241,5158,37.5469638223,126.875005296
16003,등촌역.강서보건소,3051,1948,4999,37.5491138794,126.8687187259
16004,등촌역.강서보건소,2197,3835,6032,37.5494106214,126.8675998318
16005,등촌중학교.백석초등학교,1233,1566,2799,37.5526262092,126.861438627
16006,등촌중학교.백석초등학교,636,1315,1951,37.5529052232,126.8606811411
16007,강서구청사거리.서울디지털대학교,1534,2111,3645,37.5548873841,126.8555268401
16008,강서구청사거리.서울디지털대학교,2617,2034,4651,37.5552355847,126.8540843129
16009,KBS스포츠월드,982,1204,2186,37.556782,126.850512
16010,KBS스포츠월드,1160,790,1950,37.557050527,126.848927351
16011,한국가스기술공사,443,1109,1552,37.558022,126.845633
16012,한국가스기술공사,941,612,1553,37.557971797,126.8437363221
16013,발산역,411,1689,2100,37.558502,126.83922
16014,송정역,1550,456,2006,37.561451697,126.8098252947
16015,송정역,217,967,1184,37.5613543738,126.8109375565
16016,공항중학교.마곡엠밸리9.10단지,356,90,446,37.5608007973,126.8155482638
16017,발산역,2477,992,3469,37.5585733533,126.8376109437
16018,마곡역,343,1128,1471,37.559695,126.827513
16019,마곡역,1253,377,1630,37.5597284531,126.8262227042
16020,공항중학교.마곡엠밸리9.10단지,126,467,593,37.5607379709,126.8171527623
16021,마곡동로사거리,459,1311,1770,37.5590734814,126.8339921625
16022,마곡동로사거리,1177,818,1995,37.5591051266,126.8324754968
16023,강서세무서,769,216,985,37.5601352538,126.8221992473
16024,강서세무서,155,490,645,37.5601606335,126.8228597284
16100,화원중학교,102,109,211,37.5378331474,126.8410402083
16101,가양동탑산문화공원,135,153,288,37.565718,126.846099
16102,서울식물원.식물문화센터,36,38,74,37.5683369266,126.8350580335
16103,백석초등학교.한국임업진흥원,144,141,285,37.5527036123,126.8616542673
16104,등촌중학교.한국임업진흥원,436,575,1011,37.5529521864,126.8601040507
16105,강서대학교.강서LG베스트샵,243,279,522,37.5548452055,126.8560333678
16106,하이웨이주유소.강서대학교,202,170,372,37.5545340687,126.8557934761
16107,서울식물원.숲문화학교,3,47,50,37.5662276025,126.8341460719
16108,LG사이언스파크,105,123,228,37.5619785387,126.8335273253
16109,등촌주공5단지아파트,69,160,229,37.5581926191,126.8437952791
16111,발산역4번출구,65,275,340,37.5586270014,126.8392815106
16112,발산역5번출구,84,153,237,37.5582109717,126.8394838811
16115,공항중학교,50,312,362,37.561102,126.815009
16116,송정역4번출구,118,428,546,37.5611760789,126.810720132
16117,송정역,165,296,461,37.5616789813,126.8090169265
16118,공항시장,199,237,436,37.5622654951,126.8088328704
16119,공항시장,330,274,604,37.5624230357,126.8087504097
16120,공항시장역3번출구,557,237,794,37.5638248877,126.8109493938
16121,공항시장역.공항성산교회,411,326,737,37.5647464984,126.8113840134
16122,방화주유소,35,217,252,37.566218,126.812578
16123,방화2동청성아파트앞,226,136,362,37.5669761672,126.8116149845
16124,방신전통시장입구,99,445,544,37.5699529318,126.8128627805
16125,마곡우촌아파트,445,66,511,37.5700234331,126.8114748571
16126,방신전통시장정문.방화사거리,316,477,793,37.5727187792,126.8115903308
16127,방신전통시장정문.방화사거리,502,137,639,37.5726571076,126.8113414217
16128,한서고등학교.보람아파트,7,230,237,37.57483,126.811733
16129,한서고등학교.보람아파트,240,32,272,37.574816243,126.8114186211
16130,방화역2번출구,91,686,777,37.576742,126.812627
16131,방화역3번출구,643,64,707,37.5769118737,126.8123587027
16132,방화3동주민센터.국립국어원,1,289,290,37.57913,126.813513
16133,방화7단지.국립국어원,429,35,464,37.5793082749,126.8133544706
16134,가양역4번출구.가양8단지아파트,70,123,193,37.5618621425,126.8559123678
16135,가양역7번출구.마포중고교,2666,2614,5280,37.5589275113,126.8542038866
16136,가양역8번출구.마포중고교,4319,2453,6772,37.5595591647,126.8541936005
16137,경복비즈니스고등학교,896,2182,3078,37.5575280794,126.8534482519
16138,경복비즈니스고등학교,622,542,1164,37.557662838,126.8531220051
16139,강서구청.한국건강관리협회,2657,1551,4208,37.552627948,126.8505841855
16140,강서구청.한국건강관리협회,2124,2910,5034,37.5526688733,126.8501698616
16141,우장초등학교,1965,1532,3497,37.5503532252,126.8481814428
16142,우장초등학교,1909,1949,3858,37.549366909,126.8477782735
16143,한국폴리텍1.서울강서대학교,1676,1361,3037,37.5460872756,126.8452748106
16144,한국폴리텍1.서울강서대학교,1414,1839,3253,37.5458432676,126.8447320961
16145,화곡본동시장,1002,2283,3285,37.5431786479,126.8426281976
16146,화곡본동시장,2045,1288,3333,37.5433434761,126.8432514003
16147,화곡역6번출구,1445,2110,3555,37.5410376002,126.8387505747
16148,화곡역7번출구,1444,1216,2660,37.5408730247,126.8370055717
16149,강서구청소년상담복지센터,1173,1261,2434,37.5401952775,126.8355643823
16150,화곡푸르지오,380,703,1083,37.5401506396,126.8344789776
16151,외발산신광명마을,99,470,569,37.5460645834,126.8215259396
16152,외발산신광명마을,115,238,353,37.545958,126.821132
16153,강서면허시험장.메이필드호텔,399,712,1111,37.5496838966,126.8194959796
16154,강서면허시험장.메이필드호텔,136,227,363,37.5477976201,126.820225595
16155,강서농수산물도매시장,81,108,189,37.55187,126.81998
16156,영인운수차고지,3,0,3,37.5453351183,126.8179353333
16157,대한항공.메이필드호텔,34,1,35,37.5497227693,126.8168175473
16158,공항동송정중학교,93,102,195,37.5527773034,126.8149361014
16159,공항동송정중학교,193,248,441,37.55313,126.815368
16160,국립항공박물관.공항동천주교회,208,208,416,37.555638,126.811917
16161,국립항공박물관.공항동천주교회,131,79,210,37.555152,126.811943
16162,공항동지하도입구,59,288,347,37.559087,126.808185
16163,영인운수차고지,1,3,4,37.5452133046,126.8182939748
16164,방화중학교,136,22,158,37.564621397,126.8059168195
16166,방화동도시개발11단지,66,178,244,37.570852,126.804202
16167,개화119안전센터,14,291,305,37.575195,126.8026
16168,개화119안전센터,37,14,51,37.575128,126.802225
16169,개화역1번출구.개화검문소,6,45,51,37.578455,126.800345
16170,개화역1번출구.개화검문소,567,28,595,37.5784942626,126.7997884498
16172,부석마을.상사마을입구,58,29,87,37.58182,126.798335
16173,영일고등학교.강서도서관,2526,2097,4623,37.5489885793,126.8633553696
16174,아이파크아파트.백석중학교.실로암안과,1382,1977,3359,37.5451448999,126.8621412863
16175,등촌2동주민센터.등촌동대림아파트,1000,1182,2182,37.5419424703,126.8629698908
16176,대일고교.임광아파트.배광교회,958,1238,2196,37.539791346,126.8635679255
16177,용문사.시립화곡청소년센터,1884,1560,3444,37.5370972069,126.8633458107
16178,목동사거리,316,562,878,37.5331985949,126.8635224048
16179,목동사거리,2742,2393,5135,37.5316337661,126.863608811
16180,화곡동남부시장,1349,1565,2914,37.5318363326,126.858853902
16181,성석교회,1531,813,2344,37.5315122234,126.8575906388
16182,서울신정초등학교,702,631,1333,37.5311293183,126.8529083134
16183,서울신정초등학교,817,753,1570,37.530930626,126.8525296973
16184,화곡8동주민센터,396,1074,1470,37.5308233051,126.8495911999
16185,화곡8동주민센터.까치산시장,1074,518,1592,37.5305885107,126.8488200647
16186,KT강서지사,1002,841,1843,37.5299722869,126.8475167279
16187,KT강서지사,447,565,1012,37.5299538337,126.8478810975
16188,화곡동유림아파트,230,794,1024,37.530479,126.844302
16189,화곡동유림아파트,613,434,1047,37.5303526005,126.8444275174
16190,황외과앞,384,9,393,37.5309632183,126.8378394153
16191,까치산역2번출구,4378,4189,8567,37.5317706703,126.8468455507
16192,까치산역4번출구,3936,3464,7400,37.5322386315,126.8461927843
16193,화곡동백구사,573,1187,1760,37.5326003237,126.8425221182
16194,화곡동백구사,869,391,1260,37.5323817672,126.8407943889
16195,화곡대림아파트,732,443,1175,37.5330031766,126.8389262692
16196,화곡동대림아파트.화곡중앙시장,1524,1693,3217,37.5341804114,126.8383240895
16197,강서문화원.강서K병원,878,309,1187,37.5367734994,126.8371920237
16198,강서문화원.강서K병원,298,962,1260,37.5374398713,126.8368737328
16199,강서문화원.강서K병원,370,168,538,37.5369060331,126.8366700411
16200,강서문화원.강서K병원,206,465,671,37.5371786505,126.8362926723
16201,다운어린이공원.치유하는교회,209,855,1064,37.5325644788,126.8437952234
16202,화원중학교,47,157,204,37.537977,126.840433
16203,신월초등학교,499,280,779,37.5386348969,126.8389691102
16204,신월초등학교,159,364,523,37.5389654088,126.8394911995
16205,화곡역5번출구,2182,1664,3846,37.5406479194,126.8409451288
16206,화곡역4번출구,3042,2522,5564,37.540952728,126.8411221475
16207,화곡역1번출구,667,953,1620,37.5427978434,126.8395162317
16208,화곡역8번출구,477,773,1250,37.5429294084,126.8388885788
16209,대원시장,500,510,1010,37.5440629818,126.8382263704
16210,대원시장,567,602,1169,37.5445248902,126.8373132333
16211,화곡중고등학교,953,532,1485,37.5472239799,126.8362222507
16212,화곡중고등학교,545,829,1374,37.5474202914,126.8364707757
16213,우장산역1번출구,2001,1161,3162,37.549241001,126.8365028309
16214,우장산역4번출구,2009,1376,3385,37.5497942598,126.8362284945
16215,명덕고등학교.서울스타병원,1410,1337,2747,37.5530943921,126.8365206219
16216,명덕고등학교.서울스타병원,1403,1368,2771,37.5532912365,126.8363717464
16217,발산역.우장산힐스테이트,579,775,1354,37.5560385988,126.8376254994
16218,발산역.우장산힐스테이트,964,669,1633,37.5567655856,126.8374835698
16219,발산역2번출구,1480,1058,2538,37.56009,126.838558
16220,발산역3번출구,1013,1112,2125,37.5601701491,126.8389703128
16221,서울호서전문학교.등촌주공3단지아파트,672,521,1193,37.562868,126.839465
16222,서울호서전문학교.등촌주공3단지아파트,296,686,982,37.562662,126.839755
16223,서울강서우체국,137,482,619,37.5645670875,126.8403693809
16224,서울강서우체국,239,100,339,37.5645673439,126.8400518125
16225,양천향교역.휴먼빌아파트,666,550,1216,37.5692156291,126.8416017657
16226,양천향교입구,159,321,480,37.5700307989,126.8414302464
16227,가양한강타운아파트,256,591,847,37.570402906,126.8434528337
16228,가양한강타운아파트,502,180,682,37.5705058666,126.8438103417
16229,가양2단지성지아파트.동양고등학교,255,518,773,37.5696275978,126.8465390121
16230,가양2단지성지아파트.동양고등학교,655,318,973,37.5696444144,126.84734832
16231,한보구암마을아파트,342,307,649,37.5687703572,126.8490281961
16232,가양동천주교영등포공업고등학교,287,219,506,37.5684832895,126.8496502756
16233,서울서진학교.우체국앞.허준박물관,230,228,458,37.5668487184,126.8513309956
16234,탑산초등학교.허준박물관,146,162,308,37.5666981923,126.8517605558
16235,가양4단지아파트,190,204,394,37.5652618508,126.8532911497
16236,대림경동아파트,156,125,281,37.5655880638,126.8532162499
16237,가양5단지아파트,201,241,442,37.564242,126.85513
16238,가양2동강변아파트,157,129,286,37.5641799397,126.8556380616
16239,가양6단지아파트,172,112,284,37.5629463904,126.8579043717
16240,가양초등학교,411,506,917,37.561717,126.85982
16241,강서구청별관,317,70,387,37.5611994625,126.8597589765
16242,가양3동주민센터,191,171,362,37.5614125205,126.8607529864
16243,가양9단지아파트,428,337,765,37.559812,126.863307
16244,가양9단지아파트.세현고등학교,377,369,746,37.5598119345,126.8636096929
16245,염창동아3차아파트.나이아가라호텔,240,739,979,37.5491222747,126.877626568
16246,염창동아3차아파트,378,150,528,37.5488168686,126.8776893136
16247,염창동새마을금고,486,731,1217,37.5502350947,126.8733240118
16248,염창동새마을금고,633,366,999,37.5501570313,126.8727944748
16249,염창동한마음.관음삼성아파트,571,767,1338,37.5530470916,126.8697189477
16250,염창동관음삼성아파트,733,415,1148,37.5529295507,126.8693581039
16251,태영.삼성한사랑아파트,527,271,798,37.5550652684,126.8654574304
16252,금호.한솔아파트,481,714,1195,37.5554473635,126.8654850398
16253,블루나인비지니스센터,583,445,1028,37.5562428349,126.8637439355
16254,블루나인비지니스센터,416,607,1023,37.5565070571,126.8639188939
16255,증미역1번출구.강서소방서,137,211,348,37.5578632495,126.861434589
16256,증미역3번출구.강서소방서,564,307,871,37.557230783,126.8617194697
16257,가양역6번출구.현대프린스텔,359,208,567,37.5602196054,126.8563497598
16258,가양역5번출구.현대아파트,111,358,469,37.5604119558,126.8567272077
16259,가양역9번출구.우성아파트,579,639,1218,37.5614520887,126.8539737105
16260,가양역1번출구.우성아파트,525,453,978,37.562223,126.853228
16261,SBS공개홀,350,376,726,37.5634890953,126.85080021
16262,SBS공개홀,231,340,571,37.563659097,126.8498490115
16263,가양4.5단지상가앞,43,68,111,37.5640845262,126.8526273202
16264,서울서진학교,158,172,330,37.565616,126.849851
16265,등촌동대림아파트,517,244,761,37.5644051441,126.8483940429
16266,강서한강자이아파트,360,359,719,37.5650145106,126.8478709578
16267,가양동CJ주식회사,101,151,252,37.5666541126,126.844935221
16268,가양동CJ주식회사,211,158,369,37.5668132495,126.8440630854
16269,양천향교역1번출구.양천초교,832,361,1193,37.569105,126.840356
16270,양천향교역8번출구.양천초교,177,385,562,37.568749,126.840489
16271,겸재정선미술관.서울식물원,76,270,346,37.5697783342,126.8385690451
16272,겸재정선미술관.서울식물원,226,168,394,37.5707733354,126.8372947297
16273,마곡실내배드민턴장,115,114,229,37.5726185461,126.82984731
16274,마곡실내배드민턴장,108,115,223,37.5726747685,126.8319558638
16275,서남물재생센터,22,159,181,37.5730045551,126.8273192464
16276,서남물재생센터,33,54,87,37.5727700614,126.8271584787
16277,서남환경공원.마곡청구아파트,44,318,362,37.5732822116,126.8233293081
16278,서남환경공원.마곡청구아파트,415,98,513,37.573136622,126.8222079622
16279,방화2단지아파트,520,278,798,37.573256,126.81844
16280,방화2단지아파트,248,395,643,37.573514,126.818829
16283,방화동동부센트레빌아파트,389,186,575,37.5733225126,126.8138643735
16284,방화동동부센트레빌아파트,132,487,619,37.573528,126.814217
16285,한서고등학교.방화사거리,273,240,513,37.573128,126.810512
16286,한서고등학교.방화사거리,111,265,376,37.573162,126.809421
16287,개화산역2번출구,581,219,800,37.572521,126.806172
16288,개화초교.개화산역2번출구,112,236,348,37.572655,126.805346
16291,등촌3동천주교회,129,150,279,37.5600812481,126.8457975984
16292,등촌3동천주교회,271,272,543,37.5599579041,126.8460350791
16293,등촌3동5단지아파트.등촌고등학교,196,120,316,37.561745,126.84519
16294,등촌3동5단지아파트.등촌고등학교,255,213,468,37.561949377,126.8452050542
16295,등촌3동주공4단지아파트,262,171,433,37.5624287385,126.8431809018
16296,등촌동부영아파트,303,163,466,37.562722,126.84275
16297,등촌3동주공10단지아파트,306,112,418,37.5619664289,126.8474153204
16298,등촌3동대림아파트,157,302,459,37.5625898053,126.8474900471
16301,마곡13단지힐스테이트아파트,102,90,192,37.5566960084,126.8179661823
16303,서울디지털콘텐츠고등학교,199,46,245,37.5755292328,126.8166269967
16304,방화1.2단지아파트,108,180,288,37.5752232916,126.8168824539
16305,서울백영고등학교,412,430,842,37.5695169119,126.8168322544
16306,서울백영고등학교,447,279,726,37.569091,126.816406
16307,공항중학교,96,178,274,37.5631891761,126.8162655595
16308,공항중학교.마곡엠밸리9단지,319,183,502,37.562076,126.816722
16309,양천향교역7번출구,1086,255,1341,37.5670001354,126.8407487895
16321,방신전통시장입구,205,46,251,37.5700525655,126.812660348
16322,방화주유소,33,31,64,37.5666910754,126.8125292434
16326,제과점앞,160,102,262,37.5602109477,126.8099418283
16327,공항동천주교회,83,163,246,37.557387,126.811612
16328,강서한방병원,272,1287,1559,37.5301259278,126.8390315329
16329,강서한방병원,1305,240,1545,37.5299929864,126.8393407089
16330,강서한강자이아파트,159,152,311,37.5663646057,126.8500718716
16332,강서구청별관,39,154,193,37.561162,126.859807
16339,우장산동주민센터,46,187,233,37.5479250527,126.8415761023
16340,문성유치원,129,187,316,37.5469149557,126.8442261922
16341,우장산투웨니퍼스트오피스텔,107,175,282,37.5471985703,126.8457900497
16342,가양7단지상가,8,107,115,37.560708,126.861713
16344,등촌주공9단지,40,21,61,37.561643,126.850602
16345,강서구올림픽체육센터,59,39,98,37.559912,126.850182
16346,등촌주공6단지,41,17,58,37.560553,126.848477
16347,등현초등학교,50,23,73,37.5611028771,126.847269544
16348,가양7단지상가앞,221,30,251,37.560749155,126.8618310381
16350,우장산휴먼빌아파트,220,108,328,37.5474383521,126.8434782256
16351,우장산동주민센터,99,180,279,37.5480757415,126.8414060402
16352,우장산아이파크이편한세상,18,335,353,37.548002196,126.8370211691
16361,우장산파크빌,273,136,409,37.5466528685,126.8453328761
16364,강서힐스테이트아파트,216,116,332,37.547853051,126.836963084
16366,등촌주공6단지앞,25,37,62,37.560355,126.848447
16367,강서구올림픽체육센터,23,41,64,37.559795,126.850322
16368,등촌9단지SBS공개홀,8,48,56,37.561875,126.850932
16369,가양4.5단지상가앞,15,66,81,37.563943,126.852823
16373,삼정그린코아아파트,60,59,119,37.5715960686,126.8117011886
16374,강서농협,17,93,110,37.56832217,126.8128866692
16375,강서농협,94,23,117,37.568388,126.812767
16376,서울방화초등학교,9,7,16,37.568165,126.805304
16378,공항동주민센터,61,154,215,37.55883,126.810557
16379,천주교성당,301,21,322,37.556398,126.812261
16385,마곡나루역4번출구.서울식물원,77,613,690,37.5652544127,126.8277729117
16386,마곡나루역5번출구.서울식물원,1236,325,1561,37.5653688926,126.8275009964
16387,마곡역4번출구,296,273,569,37.5593495514,126.828573099
16388,이대서울병원,353,227,580,37.5587395873,126.8348300457
16389,김포공항국내선,1099,153,1252,37.5587417798,126.804207227
16390,김포공항국내선,280,385,665,37.5583911194,126.8046467079
16391,김포공항국제선,521,498,1019,37.56531,126.801112
16393,발산역7번출구,190,118,308,37.5577386829,126.8379025495
16394,신방화5번출구,300,125,425,37.567394529,126.8174477684
16395,마곡엠밸리6.7단지.마곡중학교,263,94,357,37.5671078261,126.8214497647
16396,마곡나루역1번출구,462,198,660,37.5667539271,126.8257999476
16397,마곡역,218,559,777,37.56108,126.826863
16398,마곡역,598,666,1264,37.560522,126.827203
16399,마곡나루역1번출구.웰튼병원,483,1205,1688,37.5669558738,126.8265562889
16400,마곡동로사거리,414,474,888,37.5594674923,126.8314960803
16401,마곡엠밸리11.12단지,0,6,6,37.5600644793,126.8215712653
16402,마곡13단지힐스테이트후문,37,1,38,37.5566341229,126.8187359229
16403,공진초등학교,14,5,19,37.5584322785,126.8216428956
16408,외발산동기점,467,15,482,37.5452091516,126.8213321956
16410,한국공항공사,89,107,196,37.562433,126.798872
16411,한국공항공사,43,173,216,37.5625221156,126.7987623811
16413,개화동상사마을종점,83,100,183,37.588697,126.80181
16416,마곡수명산파크7단지,470,129,599,37.5492187282,126.8230654224
16417,마곡수명산파크5단지6단지,676,66,742,37.5513079456,126.8253549438
16418,마곡수명산파크2단지,576,81,657,37.5549071083,126.8264227097
16419,마곡수명산파크2단지,70,635,705,37.554787,126.826058
16420,마곡수명산파크3단지4단지,130,368,498,37.55168483,126.8252225589
16421,마곡수명산파크7단지,126,224,350,37.549322,126.822762
16422,마곡역6번출구,32,8,40,37.559571,126.825491
16424,화곡2동주민센터,935,691,1626,37.5313768831,126.8552226927
16425,화곡2동주민센터,744,903,1647,37.5311763199,126.854483648
16427,마곡엠밸리14단지아파트,156,511,667,37.557467,126.826412
16428,마곡엠밸리15단지아파트,330,171,501,37.5574387588,126.8267496101
16429,발산역9번출구,1089,739,1828,37.5589193253,126.8365135554
16430,공항동주민센터,80,99,179,37.558964,126.810619
16431,신방화사거리,127,326,453,37.572868,126.816922
16432,신방화사거리,580,237,817,37.5727855639,126.8165346746
16433,마곡우촌아파트,36,216,252,37.5701349,126.8117126614
16434,개화역광역환승센터,15,238,253,37.57845,126.797811
16435,개화역광역환승센터,274,9,283,37.57822,126.797978
16436,방화2동청성아파트,29,137,166,37.5665639113,126.8118933674
16450,핑크힐병원,364,306,670,37.5493147499,126.8755585298
16451,롯데몰.김포공항역,759,1725,2484,37.5623798325,126.8030234261
16453,송정중학교정문,196,62,258,37.5543372118,126.8162290783
16462,염창동주민센터,150,69,219,37.5536800855,126.871126909
16463,세븐일레븐강서메인점,60,2,62,37.5351492517,126.8561330678
16464,강원슈퍼,50,6,56,37.5356611094,126.856929141
16465,화곡보람3차아파트,55,6,61,37.5364948584,126.858238059
16466,에이엔케슬,38,22,60,37.5371360581,126.859168675
16467,한광고,25,38,63,37.5377930358,126.8584805675
16468,서울신정고등학교,67,74,141,37.5372836881,126.8575411898
16469,명지해드는터아파트,17,18,35,37.5366359765,126.8564710571
16470,동우아트빌,50,13,63,37.5364692205,126.8559329287
16471,미주아파트,28,30,58,37.5374138804,126.8549371793
16472,방송인아파트,11,43,54,37.5370334682,126.85410904
16473,곰달래약국,47,41,88,37.5315199743,126.858040957
16474,중앙하이츠빌라,5,15,20,37.5307641322,126.8581894818
16475,곰달래아파트,3,17,20,37.5296584451,126.8565795811
16476,삼성아파트,8,15,23,37.5292192105,126.8541282205
16477,은창아파트,24,20,44,37.5289352735,126.8518828439
16478,화곡전화국,69,24,93,37.5294764061,126.8479082078
16479,까치산역4번출구,753,870,1623,37.5326432888,126.8460661003
16480,까치산시장,3,175,178,37.533742673,126.8462779542
16481,화곡탑건진선미아파트,28,14,42,37.5361805507,126.8467094083
16482,GS화곡개나리점,74,9,83,37.536642,126.848008
16483,빨래터세탁소,129,13,142,37.5371687836,126.8491623939
16484,공작세탁소,2,21,23,37.536591509,126.8545741382
16485,주영렉스빌,4,21,25,37.5360470216,126.8551479825
16486,세븐일레븐강서메인점,2,46,48,37.5348425483,126.855997887
16487,국민약국,15,88,103,37.5317540263,126.8578470281
16488,주영렉스빌,47,3,50,37.5358982526,126.855045849
16489,약수터,252,85,337,37.5387776474,126.85163932
16490,신광명마을,2,94,96,37.5471082621,126.8240687003
16491,수명중고등학교,1,159,160,37.549302466,126.8240952322
16492,마곡.수명산파크4단지,2,108,110,37.550615042,126.8244871379
16494,한마음아파트,92,168,260,37.5551078122,126.8680232498
16495,우성아파트앞,136,99,235,37.5555155833,126.8708997
16496,우성아파트,108,120,228,37.5555615934,126.8709494221
16497,봉제산정상,30,13,43,37.53667,126.851795
16498,생태공원,15,5,20,37.5834338969,126.8185407653
16499,NC백화점앞,585,3,588,37.5594762964,126.8402472565
16500,염창역1번출구.강서평생학습관,1121,12,1133,37.5472979883,126.8737556441
16501,명지해드는터아파트,113,52,165,37.5367635901,126.8563584043
16502,하이웨이주유소,679,154,833,37.5544691407,126.8542799286
16503,서광아파트,84,3,87,37.5788332307,126.8194426148
16504,마곡엠밸리7단지앞,5,7,12,37.5654207293,126.8244646004
16505,대림아파트,8,19,27,37.5483303142,126.8751414211
16506,하나마트,97,44,141,37.5524923381,126.8531015943
16507,정곡초교,26,14,40,37.5760007418,126.8186173155
16508,등명중학교,67,9,76,37.5590951148,126.8429614647
16509,동아3차아파트,60,97,157,37.5494621232,126.8760290974
16510,미주아파트,110,88,198,37.5375050938,126.8551022133
16511,백연공원,72,104,176,37.5506285112,126.8520877836
16512,방화4단지,1,70,71,37.5767450272,126.8134033207
16513,등촌3동성당사거리,142,49,191,37.5588259101,126.8458653593
16514,기업은행,74,121,195,37.5502377469,126.8732764729
16515,방송인아파트,127,65,192,37.5371967258,126.8540561396
16516,강서대학교,227,188,415,37.5494785312,126.851224259
16517,방화3동주민센터,5,4,9,37.578176,126.813948
16518,등촌6단지,186,92,278,37.5595698622,126.8476782843
16519,관음삼성.보람더하임아파트,62,139,201,37.5524224634,126.8703832733
16520,공작세탁소,56,10,66,37.536466022,126.8543808707
16521,골목시장,120,123,243,37.5486194397,126.850235687
16523,등촌9단지,101,48,149,37.5614067814,126.8487623402
16524,염창중학교,142,182,324,37.5533520946,126.8709339914
16525,세븐일레븐강서메인점,101,14,115,37.5350565116,126.8558560931
16526,SK브로드밴드강서방송,269,146,415,37.5478099476,126.849284385
16527,정곡초교,2,38,40,37.5758468665,126.8195723539
16528,강서세무서.공항초교,7,27,34,37.5620054578,126.8206089735
16529,남부시장,82,97,179,37.5325197799,126.857698479
16530,수정빌딩,316,120,436,37.5458083822,126.8475437164
16532,다솔마을,6,0,6,37.555154,126.816664
16533,화곡유치원,148,100,248,37.5444216025,126.8461326678
16534,마곡엠밸리14단지,5,24,29,37.5580357905,126.8256703019
16535,등촌7단지아파트,135,173,308,37.5612633649,126.8530358421
16536,삼천리아파트,59,56,115,37.5561740306,126.8698493274
16537,화곡중앙하이츠빌라,19,3,22,37.5307477357,126.8580424207
16538,본동시장,215,412,627,37.5428311336,126.8442200427
16539,마곡엠밸리14단지,3,5,8,37.5583235271,126.8247274121
16540,한서고등학교.보람아파트,10,6,16,37.5748665364,126.8114926908
16541,한마음아파트,115,122,237,37.5550445028,126.8678151019
16542,곰달래아파트,32,15,47,37.5297942783,126.8572148649
16543,본동사무소,28,280,308,37.5427020909,126.8477354184
16544,볏골어린이공원,138,954,1092,37.5409676275,126.841975539
16545,방신전통시장앞,7,4,11,37.5733423192,126.8125870322
16546,마곡엠밸리11.12단지상가,2,12,14,37.5586626221,126.8210370123
16547,삼성아파트,23,15,38,37.5294337746,126.8542115306
16548,거성빌라,17,291,308,37.5421787361,126.8490739183
16549,마곡13단지힐스테이트상가,0,21,21,37.5583639272,126.8201379646
16550,겸재정선미술관입구,0,87,87,37.572225,126.837411
16551,한국건강관리협회,222,343,565,37.5538251223,126.8509971757
16552,증미역2번출구,69,142,211,37.557180458,126.8626080867
16553,은창아파트,37,31,68,37.5291208041,126.8518066697
16554,강서구립봉제산어르신복지센터,24,310,334,37.5417729905,126.8502912541
16555,본동시장.새마을금고본점,483,59,542,37.5428192627,126.8427421191
16556,금호APT,0,187,187,37.5743399784,126.8371204609
16557,강서구청입구,342,126,468,37.5532043177,126.8496141991
16558,등촌강변샤르망오피스텔,63,187,250,37.558624739,126.8571485471
16559,마곡13단지힐스테이트후문,2,50,52,37.5567373931,126.8179906008
16560,대영마트,13,329,342,37.5405745983,126.851055235
16561,우체국,62,53,115,37.5441939263,126.8459320265
16562,벽산아파트,0,250,250,37.5755640607,126.8367589013
16563,우장산꿈에그린아파트,113,135,248,37.5532921022,126.8477997172
16564,등촌현대아파트,58,80,138,37.5566172929,126.8550855865
16565,까치산역1번출구,1801,707,2508,37.5326055625,126.8463346005
16566,정은파크빌,8,422,430,37.540005562,126.8514173531
16567,화곡초교,81,96,177,37.543584805,126.8465565086
16568,벽산아파트,298,1,299,37.5757388784,126.8366805582
16569,롯데3차APT,82,77,159,37.5528724125,126.8465770816
16570,하이웨이주유소,91,121,212,37.5555906416,126.8540853499
16571,까치산시장,12,5,17,37.5335405699,126.8460803531
16572,약수터,71,155,226,37.5387720758,126.8515080655
16573,금호APT,112,1,113,37.574293801,126.8369597981
16574,강서구민회관,57,88,145,37.5530658323,126.8442711774
16576,선교교회,10,36,46,37.5343420215,126.8477612943
16577,겸재정선미술관입구,72,4,76,37.5718308684,126.8374304603
16578,발산어린이집,226,203,429,37.554367135,126.8416539309
16579,화곡탑건진선미아파트,9,77,86,37.5359934136,126.8468187447
16580,삼거리,143,24,167,37.5373877789,126.850132431
16581,롯데1차,1,57,58,37.554512744,126.8409792491
16583,GS화곡개나리점,12,156,168,37.5365674526,126.848043724
16586,내발산복합복지센터,134,119,253,37.5545324812,126.8399795935
16588,빨래터세탁소,6,206,212,37.5369625024,126.8492383261
16589,안골공원,10,21,31,37.5359315073,126.8512590982
16591,우장산월드메르디앙아파트,142,159,301,37.5547901531,126.8378891311
16592,방화동동부센트레빌아파트,9,0,9,37.5733691977,126.8138107751
16593,삼거리,11,187,198,37.5373368223,126.8502333606
16594,강남슈퍼,3,26,29,37.5351941142,126.8510240698
16595,프라임마트,16,11,27,37.5728737933,126.8182381117
16597,태창아파트,45,91,136,37.5375766335,126.8508560508
16598,신정초교,11,31,42,37.5325973854,126.8512080132
16599,정은파크빌,228,10,238,37.5400282017,126.851506706
16601,마곡한솔솔파크,12,5,17,37.5700446393,126.8226596037
16603,길훈아파트,2,2,4,37.5686840065,126.8225722751
16604,마곡중학교,3,1,4,37.5689619652,126.8205580115
16606,마곡나루역,562,135,697,37.5672228992,126.8277919292
16608,롯데R&D센터,49,57,106,37.5713190587,126.8284268111
16609,마곡나루역,87,247,334,37.5671626962,126.8280656444
16613,LG사이언스파크,84,116,200,37.5627653003,126.8339839711
16615,마곡엠밸리1단지,7,7,14,37.5678091263,126.8191530122
16616,마곡나루역,10,18,28,37.5666863778,126.8258170834
16617,마곡나루역5번출구.서울식물원,22,23,45,37.5653148,126.8274784835
16619,서울식물원.숲문화학교,35,21,56,37.5663159615,126.8345109127
16621,마곡역2번출구,18,23,41,37.559962965,126.8259968474
16622,강서세무서.공항초교,2,16,18,37.5619017064,126.8209337487
16623,강서세무서,0,1,1,37.5623562752,126.8213948607
16624,마곡엠밸리7단지입구,6,4,10,37.565172,126.824676
16625,마곡엠밸리7단지,22,1,23,37.5671695854,126.8235747774
16627,마곡엠밸리3단지입구,7,2,9,37.5674567613,126.8199974298
16628,마곡중학교후문,2,2,4,37.5686373065,126.8208224938
16629,길훈아파트,12,1,13,37.5688328966,126.8227000401
16630,마곡한솔솔파크,5,6,11,37.5696732566,126.8228444257
16631,프라임마트,4,9,13,37.5729863387,126.8181868983
16632,방화동동부센트레빌아파트,2,7,9,37.5735236112,126.8142022387
16633,방신전통시장앞,5,2,7,37.5736123014,126.8129196261
16634,한서고등학교.보람아파트,6,20,26,37.575012494,126.8117492228
16636,동아1.2차아파트,358,195,553,37.5546674977,126.8718806325
16637,약수터,205,312,517,37.5382837732,126.8515195211
16638,동아1.2차아파트,182,352,534,37.5546585833,126.8720632484
16640,마곡우림필유아파트,16,6,22,37.5720190366,126.8206647683
16641,마곡우림필유아파트,19,14,33,37.572048799,126.8202678013
16677,대영마트,212,13,225,37.540598138,126.851143455
16700,롯데R&D센터,22,42,64,37.5703123695,126.828545146
16702,마곡엠밸리7단지,180,279,459,37.5671761267,126.8235218525
16703,신방화역4번출구.마곡중학교,92,302,394,37.5674501387,126.8199236939
16704,신방화역7번출구,221,222,443,37.56661,126.816377
16705,마곡엠밸리4단지,59,148,207,37.5689315825,126.8249811399
16706,마곡엠밸리5단지,120,332,452,37.566192,126.816778
16707,화곡중앙골목시장,1390,1046,2436,37.5347017814,126.837775875
16718,송화벽화시장,611,243,854,37.5479822354,126.8352516144
16721,삼천리아파트,94,102,196,37.5561118066,126.869805293
16722,LG주유소,69,49,118,37.5315297061,126.8577463741
16727,강서구립봉제산어르신복지센터,305,18,323,37.5417776236,126.8503919612
16729,화곡중.고등학교,61,165,226,37.5480159963,126.8332770001
16732,삼거리,10,24,34,37.5371798683,126.850104675
16734,남부시장,250,140,390,37.5325361304,126.8578070724
16745,송정역,116,107,223,37.5613442157,126.8091452122
16778,거성빌라,167,8,175,37.542196174,126.8495909865
16812,덕원여자고등학교.덕원예술고등학교,56,145,201,37.5492511475,126.8321738366
16814,봉제산정상,5,177,182,37.5366775541,126.8516122813
16818,성우빌딩,8,9,17,37.5336266685,126.8575558378
16820,발산초등학교,25,153,178,37.550788238,126.8314177559
16836,로미오이발클럽,3,201,204,37.5360346554,126.8530365707
16849,강서면허시험장.강서농수산물시장,344,68,412,37.5500977258,126.8184684663
16851,염창역2번출구,3,765,768,37.547248,126.87631
16855,태영송화아파트,466,329,795,37.5538754466,126.867513837
16858,세븐일레븐강서메인점,45,134,179,37.5349246412,126.8562745177
16859,화곡초교,82,64,146,37.5434282911,126.8467695833
16861,수명산근린공원,17,205,222,37.552012862,126.8308140121
16862,관음삼성.보람더하임아파트,82,55,137,37.5520520784,126.8703510926
16863,청송평화아파트,4,168,172,37.5352999067,126.853736191
16864,아람마트,44,27,71,37.5344073361,126.85496215
16867,수명산파크1단지,76,399,475,37.5534189491,126.8298250178
16868,새마을금고,32,108,140,37.5503900089,126.8724183295
16869,성심사,5,58,63,37.5336888926,126.854174736
16870,성심사,39,39,78,37.5338305389,126.8540194871
16873,마곡.수명산파크2단지,25,357,382,37.5536179453,126.8278597199
16875,아람마트,3,72,75,37.5342796302,126.8550585442
16876,현대빌라,5,15,20,37.5344375855,126.8539118795
16878,화곡역7번출구,512,214,726,37.5412701723,126.8386545056
16879,마곡.수명산파크3단지,28,189,217,37.5531861489,126.8258981428
16882,청송평화아파트,64,30,94,37.5352210016,126.8538280474
16885,마곡수명산파크3단지.4단지,31,183,214,37.5517452299,126.8252405265
16887,화곡보람3차아파트,63,88,151,37.5363953179,126.8583824999
16888,로미오이발클럽,87,23,110,37.5361571618,126.8531190695
16890,푸르지오APT,181,365,546,37.5418579682,126.8311221371
16892,에이엔케슬,80,105,185,37.5372263113,126.8593609075
16894,화곡유치원,185,195,380,37.544243872,126.8462317879
16896,한광고,59,79,138,37.5378900911,126.8586511192
16897,수정빌딩,106,229,335,37.5456801149,126.8476445823
16898,수명산파크7단지정문,5,260,265,37.5479699462,126.8242285136
16899,서울신정고등학교,128,88,216,37.5374602675,126.8574726323
16900,SK브로드밴드강서방송,140,219,359,37.5475872477,126.8491829775
16903,골목시장,72,107,179,37.5484752506,126.850224658
16905,서울자동차학원,8,45,53,37.5469045098,126.8215963672
16907,강서대학교,161,180,341,37.5494011485,126.85131269
16908,백연공원,32,49,81,37.550627,126.852199
16909,하나마트,14,91,105,37.5524473101,126.8531946162
16910,강서구청후문,14,19,33,37.5504558566,126.8502252218
16911,화곡보람2차아파트,32,257,289,37.553885432,126.8540264306
16912,강서아파트,19,27,46,37.5515729471,126.850726634
16914,본동사무소,219,16,235,37.5428084269,126.8477220074
16915,황제참치,21,37,58,37.5527741489,126.8514757606
16917,청과시장2,14,3,17,37.551853645,126.8212167365
16918,콘티넨탈호텔,48,38,86,37.5540907066,126.8522416609
16920,강서면허시험장,41,11,52,37.5495010493,126.8191068363
16921,등촌역1번출구,342,207,549,37.5521998321,126.8628059244
16922,발산역3번출구,267,235,502,37.5592460652,126.8386304653
16923,수명산파크7단지상가,184,5,189,37.547383,126.821878
16925,수명산파크7단지정문,335,8,343,37.5478510746,126.8242774574
16927,수명중.고등학교,232,14,246,37.5500676051,126.8241692626
16928,기업은행,32,160,192,37.5660884052,126.8408606746
16929,마곡수명산파크5단지.6단지,334,36,370,37.551408453,126.8253974999
16931,수명산파크상가,240,23,263,37.5533409393,126.8261989751
16932,변전소,6,117,123,37.5707078403,126.8378902625
16933,수명산파크5단지아파트,366,39,405,37.5534721595,126.8281310522
16935,수명산파크1단지아파트앞,351,54,405,37.5532575299,126.8297393667
16937,수명산근린공원,207,39,246,37.5515705602,126.8309080194
16939,발산초등학교,152,102,254,37.5496273238,126.8318357277
16940,변전소,48,61,109,37.5707472783,126.8377373459
16941,화곡중.고등학교,183,322,505,37.5478756223,126.8331241842
16943,송화벽화시장,243,991,1234,37.5478714943,126.8353186306
16946,우장산월드메르디앙아파트,180,174,354,37.5546252214,126.8379443491
16948,내발산복합복지센터,117,151,268,37.5544705711,126.8395111456
16950,롯데2차,104,134,238,37.5543709679,126.8404847373
16952,발산어린이집,104,93,197,37.5542696867,126.8415567994
16954,강서구민회관,49,104,153,37.5528837238,126.8442047794
16955,방화3동주민센터,2,3,5,37.578386307,126.8136547657
16956,롯데3차APT,109,123,232,37.5527406972,126.8464573797
16957,방화동삼익아파트,13,7,20,37.5768069244,126.8132284757
16958,공영주차장,141,249,390,37.5531867241,126.8478384134
16960,강서구청입구,296,340,636,37.553128,126.849806
16961,서광아파트,0,38,38,37.5788326481,126.8196509419
16962,생태공원,0,4,4,37.5834824238,126.8185765185
16963,등촌7단지,260,149,409,37.561277084,126.8531999292
16964,등촌10단지,65,123,188,37.5615336843,126.8486443616
16965,등촌미주.진로아파트,78,137,215,37.5599069591,126.8477466451
16966,등촌3동성당사거리,55,205,260,37.5589634783,126.8456364312
16967,등촌5단지,6,65,71,37.5591423356,126.8439155633
16968,공원앞,0,149,149,37.5593503403,126.8417735551
16969,발산역.NC백화점,74,444,518,37.5597454044,126.8394594755
16970,동우아트빌,54,29,83,37.5365679159,126.8560740901
16971,태창아파트,75,21,96,37.5377535138,126.8507879488
16972,김포공항역3번출구,32,310,342,37.562537698,126.801792135
16975,강서농수산물도매시장,172,185,357,37.553498,126.818103
16976,강서농수산물도매시장종점,30,10,40,37.5545167694,126.8226727076
16977,등촌동주공9단지,11,70,81,37.5629182758,126.8497520174
16978,등촌주공9단지,96,54,150,37.5627349056,126.8499826351
16979,등촌동주공8단지,134,151,285,37.5621012565,126.8513904609
16986,등촌주공8단지,107,124,231,37.5616236673,126.852100007
16994,강원슈퍼,18,70,88,37.5355160159,126.8570263026
17001,신도림역,7475,2786,10261,37.5096755487,126.8892229203
17002,신도림역,3010,7268,10278,37.509108047,126.8884638807
17003,신도림동.구로역,1051,1475,2526,37.5060021376,126.8839791469
17004,신도림동.구로역,1942,2624,4566,37.5053435935,126.883227988
17005,구일역.중앙유통상가,1722,2223,3945,37.4998806283,126.8746997523
17006,구일역.제일제당,1891,2130,4021,37.499702506,126.8745360708
17007,동양미래대학.구로성심병원,2038,2527,4565,37.4996343963,126.8679976691
17008,동양미래대학.구로성심병원,2656,1615,4271,37.4993764843,126.8670186731
17009,개봉역.영화아파트,1464,2016,3480,37.496906783,126.8601789687
17010,개봉역.한마을아파트,2125,1373,3498,37.4964773551,126.8620566339
17011,경인중학교.개봉사거리,602,1124,1726,37.4973830961,126.8554228318
17012,경인중학교.개봉사거리,1056,726,1782,37.4971710251,126.8551315518
17013,구로디지털단지역,8845,3080,11925,37.4830994287,126.9015481288
17101,신도림역,238,349,587,37.5065472241,126.8921030964
17102,신도림역,3693,3176,6869,37.5070158798,126.8915707873
17103,서울미래초등학교,66,602,668,37.505102,126.889452
17104,서울미래초등학교,444,270,714,37.505305,126.889449
17105,한국SGI,694,235,929,37.5024770437,126.889782059
17106,거리공원.구로신협본점앞,454,779,1233,37.502779976,126.8885488917
17107,거리공원,438,287,725,37.4999741464,126.8918354857
17108,구로도서관.대성스카이렉스,436,517,953,37.4995635433,126.8910758305
17109,구로고등학교,900,754,1654,37.4965681073,126.8915774772
17110,영림중학교,522,875,1397,37.4969140891,126.8916231394
17111,구로구청,632,477,1109,37.4945619511,126.8879268367
17112,구로구청,1184,1966,3150,37.4947508763,126.8876042378
17113,고대구로병원후문,701,615,1316,37.4932322453,126.8845657252
17114,대림역,318,751,1069,37.4909457511,126.8939771601
17115,대림역,488,387,875,37.491137055,126.8937987946
17116,영서중학교,475,401,876,37.4898314022,126.8922034695
17117,영서중학교,97,137,234,37.4902009359,126.8923358014
17118,구로두산아파트,320,135,455,37.488807,126.890072
17119,구로종합사회복지관,362,471,833,37.487893,126.889168
17120,남구로역2번출구,463,952,1415,37.485278,126.886787
17121,남구로역5번출구.구로4동자치회관,448,359,807,37.48531,126.886453
17122,한국산업단지공단.이마트구로점,847,968,1815,37.4841410978,126.8967540585
17123,고용노동부관악지청.이마트구로점,452,364,816,37.4836510446,126.8980497122
17124,디지털산업1단지,445,497,942,37.4838512637,126.8950386925
17125,디지털산업1단지,524,378,902,37.4839658982,126.8947643486
17126,하이엔드1차.보건지소.치매센터,1157,596,1753,37.4817477698,126.8929302011
17127,지하이시티.보건지소.치매센터,140,395,535,37.4816976566,126.8926352264
17128,디지털단지오거리,520,249,769,37.4800217989,126.8908838882
17129,디지털단지오거리,88,430,518,37.479933,126.890398
17130,퀸즈빌,27,158,185,37.4873137848,126.8328027215
17131,가리봉시장,1337,928,2265,37.4830082864,126.8871282217
17132,가리봉시장,660,1098,1758,37.4824285977,126.8869928718
17133,남구로역3번출구,1381,1702,3083,37.48418,126.886268
17134,남구로역,1890,1125,3015,37.4860984011,126.8856450789
17135,구로시장,866,1653,2519,37.4879909258,126.884862123
17136,구로시장,909,982,1891,37.48798,126.88461
17137,구로4동우체국.고대구로병원정문,2939,1938,4877,37.4902484188,126.8842398696
17138,구로4동우체국.고대구로병원정문,3103,2494,5597,37.4899022236,126.8840651203
17139,구로119안전센터,1338,707,2045,37.4937842571,126.8832312859
17140,구로119안전센터,653,1717,2370,37.4938362491,126.8829563911
17141,우리유앤미아파트,565,756,1321,37.4967741772,126.8823840611
17142,구로변전소.구로초등학교,812,838,1650,37.4977886895,126.8840766793
17143,구로2동성당,1724,1156,2880,37.4995738531,126.8823344295
17144,구로역.NC신구로점,2209,1750,3959,37.5000384326,126.8828494432
17145,구로역.NC신구로점,2086,3182,5268,37.5008460428,126.88258057
17146,구로역.구로기계공구상가,1504,778,2282,37.5035680895,126.8793093405
17147,구로역.구로기계공구상가,508,774,1282,37.5034172875,126.8789985402
17148,기업은행구로중앙지점,589,321,910,37.5051655805,126.8774020097
17149,기업은행구로중앙지점,641,989,1630,37.5048734598,126.8772441351
17150,두암빌라,45,68,113,37.4950860911,126.8257158995
17151,항동우남퍼스트빌,175,133,308,37.476616334,126.8190130591
17152,신도림중학교,499,545,1044,37.5064944251,126.8849526908
17153,신도림중학교,295,470,765,37.506772,126.884705
17154,구로역,206,379,585,37.50455,126.882277
17155,구로역,210,275,485,37.5048451046,126.8821395273
17156,초롱타운회전교차로,22,82,104,37.4957030464,126.8798378767
17157,솔길공원,43,35,78,37.4892906662,126.8803654599
17158,GS25,73,25,98,37.4928832739,126.8802099004
17159,한일유앤아이아파트,1,151,152,37.4856462135,126.8760349245
17160,항동우남퍼스트빌,119,132,251,37.4766823207,126.8187528849
17161,구로SKV1지식산업센터,177,87,264,37.4776891435,126.8171864748
17162,구로SKV1.제일풍경채포레스트,124,181,305,37.4775798985,126.817092711
17164,개봉사거리,447,842,1289,37.4971447123,126.8572965027
17166,경인중학교,1027,642,1669,37.496895371,126.8563001796
17168,개봉치안센터,7,40,47,37.4981960239,126.8518576272
17169,오류1동주민센터.오류문화센터,1077,368,1445,37.4968379665,126.8461421452
17170,오류1동주민센터.오류문화센터,1429,2123,3552,37.4965314426,126.844651036
17171,오류동역,1172,1268,2440,37.4956918469,126.8433601337
17172,오류동역,1303,782,2085,37.4956023105,126.842536958
17173,씨티월드,1202,1144,2346,37.4944628984,126.8406826769
17174,오류지구대.신오류주유소,674,677,1351,37.4942645442,126.8394647757
17175,서울가든빌라앞,147,93,240,37.4912029363,126.8311075695
17176,서울가든빌라앞,155,109,264,37.4915630038,126.8316708345
17177,성공회대학교유한공고앞,201,350,551,37.4894469463,126.8250439465
17178,영풍마드레빌아파트.소공원사거리,60,146,206,37.4911309317,126.8395380549
17179,연세중앙교회,549,333,882,37.4931082751,126.8354231175
17180,궁동청소년문화의집,436,390,826,37.4933235239,126.8328204225
17181,궁동청소년문화의집.구로검사소,428,404,832,37.493133206,126.8336321895
17182,우신고등학교,713,1437,2150,37.4933,126.830847
17183,우신고등학교,675,443,1118,37.4930633974,126.8304506092
17184,온수역,121,4872,4993,37.492802,126.82376
17185,온수역,5296,260,5556,37.492777021,126.8244009171
17186,온수동새마을금고,154,14,168,37.4960559471,126.8243871935
17187,정진학교.온수힐스테이트아파트,668,871,1539,37.4969745872,126.8221461174
17188,수궁동주민센터,234,913,1147,37.494651,126.830866
17189,수궁동주민센터,399,226,625,37.4943591334,126.8308533319
17190,수궁119안전센터,180,1152,1332,37.496815,126.829596
17191,수궁119안전센터,861,140,1001,37.4967842434,126.8293338512
17192,예림디자인고.오류고.서울공연예술고,527,1566,2093,37.498605,126.829242
17193,예림디자인고.오류고.서울공연예술고,2243,326,2569,37.4984,126.82904
17194,서서울생활과학고.궁동도서관,281,279,560,37.5028393881,126.8289709829
17195,서서울생활과학고.궁동도서관,184,214,398,37.5022044887,126.8291844801
17196,오남중학교.삼미주택,120,74,194,37.4885327485,126.8367978524
17197,오남중학교,52,291,343,37.4881037428,126.8371570428
17198,구로2동지하차도입구,48,61,109,37.4901970753,126.8812544782
17201,구로우체국.이펜하우스5단지후문,149,56,205,37.48194555,126.8422808239
17202,천왕역4번출구,290,203,493,37.4859413996,126.8393714866
17203,오류2동주민센터,118,116,234,37.4886434308,126.8397819774
17204,오류2동주민센터,41,123,164,37.488882039800004,126.8396655682
17205,오류2동새마을금고,235,141,376,37.4905229687,126.8406511512
17206,오류2동새마을금고,213,289,502,37.4906222096,126.8405721054
17207,대원주유소,1079,1244,2323,37.4869343975,126.8565297879
17208,대원주유소,1020,956,1976,37.4873583985,126.8561852068
17209,현대아파트.개봉중앙시장,1955,1033,2988,37.4907570595,126.8561310188
17210,현대아파트.개봉중앙시장,1432,2364,3796,37.4905337369,126.8558657202
17211,덕의초등학교,550,397,947,37.5063377311,126.8594403333
17212,덕의초등학교,877,1134,2011,37.5061580205,126.858358201
17213,고척근린공원,828,393,1221,37.5047224619,126.8552979346
17214,고척근린공원.고척도서관,337,633,970,37.5046337292,126.854469381
17215,세곡초등학교,1577,461,2038,37.5026683511,126.8498423009
17216,세곡초등학교,283,790,1073,37.5031820473,126.8506070009
17217,개봉푸르지오아파트,607,800,1407,37.5021368312,126.8478312344
17218,개봉푸르지오아파트,1092,479,1571,37.5019938418,126.8480532092
17219,고척근린시장,687,151,838,37.5011232856,126.8508090334
17220,용두연립,472,267,739,37.4990015306,126.8517949619
17221,우리유엔미아파트,100,103,203,37.497215043,126.8826343167
17222,구로2동성당,81,64,145,37.4998375728,126.8825792166
17223,고척파크푸르지오아파트,874,633,1507,37.5075421206,126.8593137054
17225,고척시장,1180,1460,2640,37.5038511025,126.8619416162
17226,고척시장,1499,947,2446,37.5031371138,126.8619909959
17227,고척중학교,869,1509,2378,37.5004655551,126.8638647293
17228,고척중학교,925,660,1585,37.5009671461,126.8632418182
17229,구로디지털단지역,1112,488,1600,37.4834896886,126.9016459933
17230,삼부르네상스.효성아파트,1354,2806,4160,37.4787444391,126.8946360021
17231,구일우성아파트,168,216,384,37.4894975873,126.875700839
17232,구일우성아파트,211,426,637,37.49013,126.875812
17233,개봉역,1999,2354,4353,37.4939788787,126.8567241653
17234,개봉역,1389,1006,2395,37.4934843485,126.8575703808
17235,개봉1동사거리.개봉푸르지오아파트,1006,1699,2705,37.5014132308,126.8467946502
17236,개봉1동사거리,1567,809,2376,37.5004695107,126.8469150982
17237,구로1동우체국,256,213,469,37.4915682929,126.8745025992
17238,구일우성아파트,266,180,446,37.4887147629,126.8762607392
17239,디지털단지입구,366,398,764,37.4864236935,126.8764578415
17240,구로보건소,483,496,979,37.5002307166,126.8891718481
17242,구일우성아파트,482,567,1049,37.4897430284,126.8758256916
17243,개봉역,138,662,800,37.4934472423,126.8570002311
17244,웰크론,156,52,208,37.4829060991,126.8938547373
17245,남구로역2번출구,147,842,989,37.4849321706,126.8873712478
17246,개봉고가,898,1138,2036,37.493656008,126.8555849791
17247,구로남초등학교,273,475,748,37.4839895253,126.891010543
17248,연세중앙교회,530,627,1157,37.4933027885,126.8359813615
17249,가리봉파출소,439,1092,1531,37.4792463871,126.8917410052
17251,동양빌라,103,24,127,37.4951898369,126.8315970998
17252,남구로역6번출구,470,196,666,37.4877324957,126.8885673801
17253,궁동입구,33,11,44,37.4934389034,126.8340799962
17254,현대아파트,31,80,111,37.504635,126.886618
17255,롯데아파트,29,70,99,37.502823088,126.8847254607
17256,구로역.NC신구로점,82,101,183,37.501827,126.882557
17257,롯데아파트,42,20,62,37.5027211681,126.8847503711
17258,제중병원,16,36,52,37.5036149757,126.8866148382
17259,구로역,95,91,186,37.5020712449,126.8827750112
17260,구로중앙하이츠아파트.화원복지관,31,9,40,37.4982866627,126.8798196011
17261,신동아미래지움아파트,23,25,48,37.5001207745,126.8803764558
17262,초롱타운아파트,97,21,118,37.4958292381,126.8800116763
17267,한양수자인아파트앞,306,96,402,37.478107152,126.824629467
17289,온수동종점,3,258,261,37.491642,126.821273
17290,온수동종점,998,221,1219,37.4919683896,126.8212178349
17293,구로구청,1852,963,2815,37.4959285478,126.8884812232
17296,대림역,423,468,891,37.4935009845,126.8943735141
17297,구로중학교,399,419,818,37.4930931479,126.8908083287
17298,우신고등학교후문,40,312,352,37.4960440674,126.8249030466
17299,동양빌라,3,78,81,37.4953170918,126.8313006741
17300,궁동입구,15,41,56,37.4934553153,126.8342168006
17304,동부골든아파트,407,549,956,37.4987307095,126.8401618889
17305,거성푸르뫼아파트,213,210,423,37.5003224419,126.8433197716
17306,거성푸르뫼아파트,132,302,434,37.5006160982,126.8435534104
17307,오류동삼거리,509,188,697,37.4953703071,126.8408783505
17308,오류동삼거리,36,259,295,37.495268,126.840776
17309,동부골든.한신플러스타운,454,535,989,37.4986318974,126.84038262
17310,구로역.나인스애비뉴,594,567,1161,37.4998227914,126.8834797536
17311,개봉1동사거리,391,405,796,37.5012109084,126.8453708568
17312,개봉1동사거리,410,292,702,37.5010678452,126.8455328891
17314,동부골든아파트후문,136,307,443,37.50008,126.842311
17315,동부골든아파트후문,205,243,448,37.4995684704,126.8419150635
17359,항동하버라인3단지,163,263,426,37.4787466063,126.8229434162
17360,항동하버라인3단지,318,119,437,37.4791611089,126.8230450799
17361,푸른수목원,112,280,392,37.4814946582,126.8244378246
17362,항동복합행정센터,69,192,261,37.47963057,126.8220933898
17363,푸른수목원,337,61,398,37.4811903562,126.8245517616
17364,항동복합행정센터,163,111,274,37.4795204776,126.8222801975
17365,푸른수목원후문.저수지앞,35,228,263,37.4842895838,126.8224245449
17366,매화빌라,28,51,79,37.4766543306,126.8231546765
17367,그린빌라정문,22,108,130,37.4860432475,126.8234321788
17368,매화빌라,78,39,117,37.4767123949,126.8233185065
17369,푸른수목원후문.저수지앞,278,30,308,37.4837822633,126.8222927163
17370,항동중흥S클래스,131,277,408,37.4810835927,126.8216009197
17371,항동하버라인2단지,378,81,459,37.4812765042,126.8216570282
17389,디지털단지오거리,2348,1262,3610,37.4801153252,126.8887534687
17397,연지타운2단지,54,177,231,37.4837306939,126.8408329321
17399,연지타운2단지,387,217,604,37.4838000329,126.8412297964
17400,원각사입구,211,203,414,37.500556585,126.829525707
17401,삼각공원,7,31,38,37.5018533676,126.892519811
17404,고척고교.한일유앤아이.삼익아파트,31,441,472,37.5082359497,126.8524610449
17405,삼덕마을입구,4,154,158,37.5074796322,126.8500803806
17406,삼덕마을입구,186,24,210,37.5073408903,126.8501021495
17407,그랜드아파트.홍진연립,0,68,68,37.5080832696,126.8479514122
17408,그랜드아파트.홍진연립,37,5,42,37.5079066695,126.8479004502
17409,오류중학교,165,128,293,37.5079749478,126.8469113077
17410,연지마을,69,48,117,37.4827630327,126.8422699115
17456,경남아너스빌아파트,75,43,118,37.4908457534,126.8394522242
17457,서울남부교정시설,106,79,185,37.476880812,126.8397337562
17458,오류남초등학교후문,77,72,149,37.4893156441,126.8371911609
17459,서울남부교정시설입구,40,0,40,37.4767954359,126.8416444106
17460,천왕이펜하우스6단지후문,0,37,37,37.4772612987,126.8419539928
17461,미래여성병원,0,18,18,37.4912852444,126.8402025104
17462,동부그린아파트,7,47,54,37.4900476268,126.8322991004
17463,오류동푸르지오아파트.송기산내과의원,5,1,6,37.4912984558,126.8415590556
17464,1호선구일역,101,65,166,37.4954759601,126.8722335954
17465,SK허브수.구로우성APT,345,155,500,37.4954827267,126.8733862133
17468,그린빌라정문,86,39,125,37.4858461022,126.8234378684
17469,경서농협앞,51,24,75,37.5026744371,126.8639481068
17470,고척고교.한일유앤아이.삼익아파트,510,34,544,37.5080362968,126.8526426081
17471,구388버스정류장,29,42,71,37.5003117758,126.8468826207
17472,구로디지털단지역,1018,984,2002,37.4844843828,126.9014954263
17473,천왕역3번출구,1137,700,1837,37.4871929928,126.8386190723
17474,대림역4번출구,3251,2621,5872,37.4944080607,126.8941899471
17475,동아1차APT105동,179,142,321,37.5100830194,126.882003406
17476,오류동역.시장입구,79,152,231,37.4934669594,126.843811445
17477,개봉한진아파트.기점,1309,16,1325,37.4860467262,126.8520772506
17478,개봉역,2157,1478,3635,37.4951118049,126.8586855509
17479,개봉역,1464,1267,2731,37.495033642,126.8581281453
17481,구.사조참치,466,179,645,37.4831747617,126.9000463797
17483,신도림중학교,296,74,370,37.5106973286,126.8844435798
17484,개봉사거리,723,203,926,37.4974414153,126.8559170573
17485,우리은행앞,17,3,20,37.4922658527,126.8434599895
17486,123전자타운.2001아울렛,272,345,617,37.4970967423,126.8623393681
17488,개봉3동주민센터,509,23,532,37.4861608749,126.8540163564
17489,국민은행.구로구민회관.구로아트밸리,151,485,636,37.4958206432,126.8896835849
17490,1호선구일역,494,464,958,37.4953053758,126.8722280634
17491,용두연립,67,394,461,37.4987991162,126.8520611459
17492,남부종합상가,6,1,7,37.4916654326,126.8424808884
17493,고척공구상가,195,169,364,37.4985058366,126.8606650829
17494,개봉전화국,158,89,247,37.4863577406,126.8560065996
17497,세븐일레븐편의점,90,43,133,37.4916515773,126.8557099187
17499,대림6차태영프라자,254,51,305,37.5062518631,126.8831869844
17501,고척초등학교,127,206,333,37.4996410325,126.8580364886
17502,개봉1동주민센터,16,116,132,37.5003864446,126.851015214
17503,보람아파트,166,60,226,37.4862853517,126.8968737126
17504,개봉역.림괄아파트,3901,2849,6750,37.4938820371,126.8586839524
17505,덕의초등학교,20,85,105,37.5056424974,126.8576518404
17506,이마트,44,77,121,37.4915710921,126.8540092198
17507,구로고대병원정문,132,577,709,37.492350833,126.8834653518
17508,대림5차아파트.신도림주민센터,13,56,69,37.5074485074,126.8813606125
17509,세곡초등학교,161,580,741,37.5027164013,126.8493637685
17511,새마을금고사거리,51,322,373,37.501699289,126.8590429861
17512,삼환로즈빌아파트,168,95,263,37.4988849269,126.8567826449
17513,낙원할인마트,8,183,191,37.4999783857,126.8495365977
17514,오류고등학교.수궁동복지회관,13,43,56,37.4987611751,126.828651886
17515,경북슈퍼마켓,176,36,212,37.4881783244,126.856838177
17516,오류동삼거리,1,105,106,37.4956760571,126.8404273128
17517,대림5차아파트702동,137,98,235,37.5076585727,126.879686208
17520,서울가든아파트,31,118,149,37.5010736844,126.8603584192
17521,성화단지앞,16,202,218,37.5004598987,126.8557461282
17524,현대별장맨션타운4차.덕성교회,5,3,8,37.498153468,126.8265496413
17526,구로2동지하차도입구,44,183,227,37.4901642749,126.8811730911
17527,대림3차아파트,70,77,147,37.5068806092,126.8784997827
17529,고척1동주민센터.한효아파트,21,78,99,37.5007747419,126.8620826591
17530,대우아파트,59,459,518,37.5023562812,126.8561270364
17532,개봉1치안센터,33,153,186,37.5033774485,126.8469792868
17533,우신중.고후문,12,42,54,37.4960073153,126.8255107353
17534,항동중학교,3,133,136,37.4832367515,126.8220254808
17535,항동중학교,97,6,103,37.4827584773,126.8215347891
17536,한일유엔아이APT.현대로얄APT,105,171,276,37.4859901255,126.8765437603
17537,신도림미성아파트,164,126,290,37.5060035465,126.8764810511
17539,금강수목원아파트정문.동도아트빌,1,97,98,37.489296446,126.8324990347
17540,청구아파트후문,19,162,181,37.501145848,126.8635070759
17541,경남아파트앞,9,132,141,37.5039155326,126.8564113368
17543,삼원목욕탕,28,234,262,37.5047237058,126.8462944948
17544,온수초교후문,2,15,17,37.4943446088,126.8247851552
17547,월드아파트,124,52,176,37.5053880289,126.8768478866
17549,서해그랑블아파트.금강수목원아파트후문,191,191,382,37.4883202706,126.8309460994
17550,고척시장,52,230,282,37.5031035319,126.8623769754
17551,양우아파트,29,184,213,37.5048737044,126.8559186097
17552,경북슈퍼마켓,82,189,271,37.4881090525,126.8569162913
17554,오류중학교,15,281,296,37.5064968072,126.8454006743
17555,온수역,76,115,191,37.4929546615,126.8250914854
17558,센츄리아파트,18,53,71,37.5049657103,126.861266221
17559,고척2동주민센터.고척지구대,459,135,594,37.5066044971,126.8585085869
17560,철산교앞,97,17,114,37.4880930845,126.8594179846
17563,우신중.고후문,10,4,14,37.4958721554,126.8255144427
17566,오류동교회,7,38,45,37.4967301913,126.8396347971
17568,리가아파트,94,101,195,37.5060594811,126.8608037353
17569,덕의공원,8,43,51,37.5068789765,126.8557620049
17570,현대IPARK후문,6,14,20,37.488916585,126.8600859026
17572,건강약국,4,225,229,37.502795896,126.8446459743
17573,현대별장맨션타운4차.덕성교회,3,11,14,37.4981049614,126.8266538041
17575,항아리,53,126,179,37.498675859,126.8864311689
17576,한일유엔아이APT,105,187,292,37.4856182438,126.8759503543
17577,럭비구장,0,122,122,37.4912788599,126.8269979954
17578,세양청마루아파트,177,141,318,37.5067232768,126.8623952149
17579,진성아파트,4,69,73,37.5070726009,126.8550887704
17580,현대IPARK정문,31,39,70,37.4910441607,126.8609086066
17581,개봉전화국,89,348,437,37.486443343,126.8560120887
17582,개봉중학교,651,524,1175,37.5022999322,126.8429598212
17583,오류중학교,334,28,362,37.5064984287,126.8452626754
17584,오류고등학교.수궁동복지회관,34,19,53,37.4986707024,126.8284021432
17588,온수역,697,773,1470,37.4920372556,126.8238225007
17589,경남1차.중앙하이츠아파트,46,49,95,37.5053633498,126.8630129852
17590,구민체육센터후문,4,215,219,37.5075268453,126.8539611844
17591,현대2차APT,58,37,95,37.4918808558,126.8605440388
17592,개봉3동주민센터,3,422,425,37.4862735028,126.8540082216
17593,건강약국,170,0,170,37.5026653155,126.8447061907
17594,삼원목욕탕,214,31,245,37.5047100465,126.8461848075
17596,거성아파트,111,178,289,37.4898606654,126.8507701923
17597,GS25.한신아파트,2,74,76,37.4957338159,126.8740426758
17598,구로고.구로도서관,162,137,299,37.4985698798,126.8908027614
17600,천왕역1번출구,104,257,361,37.4857661404,126.839174728
17601,오류동역2번출구,233,21,254,37.4936291139,126.8437913183
17602,미래빌라,5,9,14,37.4927076915,126.841989635
17603,우림필유아파트,6,25,31,37.4942450511,126.8471890485
17604,동부에이스,27,19,46,37.4949027142,126.8497169806
17605,개봉푸르지오후문,0,37,37,37.5001701123,126.8491644859
17609,개봉푸르지오정문,13,86,99,37.5010457523,126.8487500846
17610,개봉1동사거리,6,106,112,37.5014161085,126.8455449816
17612,신도림역.아이파크아파트,198,189,387,37.5106073682,126.8884580806
17613,동아2차아파트상가,88,11,99,37.5086078017,126.8867871382
17615,동진빌라.오정초등학교,6,34,40,37.4906689295,126.8253388224
17617,마젤란아파트.예인학원앞,122,60,182,37.5044086255,126.86329633
17619,개봉한진아파트.기점,1,1055,1056,37.486149449,126.8520747864
17620,정도주택,35,14,49,37.4941055704,126.8516946619
17621,신세기아파트,0,19,19,37.4939095368,126.8534477948
17622,브라운스톤,4,52,56,37.4908930422,126.853145557
17623,개웅어린이공원,130,162,292,37.4899561133,126.8532406776
17624,거성슈퍼,8,8,16,37.4899576833,126.8526922638
17625,대림그린빌라,14,28,42,37.4899621316,126.8518549807
17626,에덴맨션,41,28,69,37.49271774,126.851471249
17629,구로보건소.금호새솔아파트,193,330,523,37.5003559042,126.8905654986
17632,한화비즈메트로,197,188,385,37.4806468628,126.8935677367
17633,한국산업기술시험원.디지털탑프라자,38,142,180,37.4816125117,126.8973623264
17634,구로디지털단지우체국,7,147,154,37.482986979,126.898151636
17635,JNK디지털타워,160,71,231,37.4820919266,126.8974691724
17636,에이스하이엔드타워2차.G밸리산업박물관,151,143,294,37.4808110245,126.8957891455
17637,대륭포스트타워8차,80,118,198,37.480603,126.894584
17638,에이스하이엔드타워1차,79,116,195,37.4812229151,126.8929111643
17650,연지타운2단지,60,59,119,37.4819347512,126.8448667042
17651,연지타운2단지,140,87,227,37.482105537,126.8452304506
17655,지타워.G밸리산업박물관,217,161,378,37.4805579915,126.894941545
17673,작은굴다리,16,2,18,37.5029616981,126.8455401063
17675,개봉1치안센터,98,37,135,37.5032887727,126.8466955709
17677,하이츠.영화.우방.한국현대,166,159,325,37.4968524879,126.8748540294
17678,영림중학교,64,128,192,37.4976740286,126.8915080266
17682,유한공고.성공회대앞,179,170,349,37.4884799619,126.8246023937
17684,우성꿈동산.산업인아파트,141,44,185,37.5035347914,126.8636135714
17686,거성푸르뫼아파트입구,13,53,66,37.5013221734,126.8463908198
17689,삼성그린빌라,31,39,70,37.4904850642,126.8516794789
17690,SK허브수.한신아파트,122,0,122,37.4956839983,126.8738018673
17694,구로구민회관,146,119,265,37.4962991173,126.8905572831
17695,KEB하나은행,135,250,385,37.4844929907,126.8957736653
17697,동삼빌라,10,62,72,37.4872651448,126.8239106044
17700,천왕이펜하우스2단지,88,176,264,37.4856524684,126.8379747224
17701,구로우체국.이펜하우스3단지후문,44,105,149,37.4818958135,126.8421452538
17704,금강수목원아파트,97,64,161,37.4892937423,126.8343982965
17706,덕성빌라,76,81,157,37.4911148827,126.8516375218
17707,현대상선.구일중학교,141,6,147,37.4953252995,126.8745918696
17708,구로구청,228,154,382,37.4946872845,126.8891800402
17709,오류동교회,13,59,72,37.4969772246,126.8397315321
17711,한일한의원,17,19,36,37.5019399059,126.8644523136
17712,항동하버라인10단지,326,32,358,37.4797625072,126.8256919615
17713,큰굴다리,10,3,13,37.4993066553,126.8472760003
17715,항동제일풍경채,38,47,85,37.4758934433,126.8168720063
17716,선경아트빌라,58,61,119,37.4920015162,126.8515320329
17717,구로중학교,297,191,488,37.4932861016,126.8901809694
17718,항동생활체육관,38,77,115,37.4773996567,126.822706461
17728,유풍약국,29,69,98,37.5012731714,126.8653108421
17729,구민체육관후문,117,6,123,37.5074094044,126.8537204834
17730,개봉교입구,44,25,69,37.4859598389,126.856147179
17731,알뜰슈퍼,133,5,138,37.4995526493,126.848671162
17733,크로바마트,89,29,118,37.4935475792,126.8514133118
17734,동구로새마을금고,42,96,138,37.4911085369,126.8921564037
17737,동양미래대학교.구로성심병원,120,210,330,37.500294065,126.8664492745
17738,진성아파트,51,7,58,37.5069198246,126.8549532265
17739,대원카센터,19,56,75,37.4851235277,126.854604124
17740,낙원할인마트,35,10,45,37.4998367818,126.8496002799
17741,개봉사거리,63,666,729,37.4971205133,126.8558271962
17743,구로주공APT,134,64,198,37.4915573877,126.8759201764
17744,구로시장.남구로시장,133,256,389,37.4892915192,126.8909461726
17746,푸른수목원후문,8,1,9,37.4842022996,126.8225267529
17747,청구아파트.동아한신아파트,59,21,80,37.500508084,126.8644775225
17748,덕의공원,56,36,92,37.5065732115,126.8559436211
17749,한진APT후문,49,95,144,37.4838124632,126.853907849
17750,개봉1동주민센터,36,30,66,37.5003180166,126.8510594597
17772,구일우성아파트,118,63,181,37.4899012173,126.8758107584
17773,구로3동주민센터.삼성래미안아파트,329,178,507,37.4874106408,126.8905108892
17792,고척1동주민센터.한효아파트,39,36,75,37.5008337327,126.8624422171
17801,금강수목원아파트,40,62,102,37.4894582587,126.834457297
17802,항동하버라인4단지,132,11,143,37.4819037911,126.8254007227
17803,고척2동주민센터.고척지구대,44,188,232,37.5064024799,126.8585760434
17804,별장쉐르빌앞,109,26,135,37.487103,126.833089
17806,덕일전자공업고등학교,12,99,111,37.4898476996,126.8375264019
17807,개명초교,21,71,92,37.482280857,126.852674925
17808,항동하버라인4단지.푸른수목원,0,134,134,37.4827177694,126.825955666
17809,항동하버라인3단지아파트,38,340,378,37.4797321396,126.8252503196
17831,우성아파트,201,42,243,37.5115844827,126.8856063291
17834,신도림역,664,209,873,37.5105577543,126.8897750974
17835,도림천역2번출구,40,17,57,37.5145732142,126.883116065
17838,구로3파출소,179,158,337,37.4861491173,126.8916518401
17846,동삼빌라,51,92,143,37.4871985611,126.8239763483
17848,천왕이펜하우스3단지입구,165,624,789,37.482418,126.838209
17855,신도림동아3차아파트,51,2,53,37.5102108312,126.8836884687
17863,구로보건소,563,309,872,37.5003597239,126.8889643647
17864,서울가든아파트,156,49,205,37.5011612274,126.8604736214
17886,고척사거리.고척파크프리지오,118,225,343,37.50682458,126.8596543326
17887,대상APT,31,82,113,37.4820568521,126.8499684334
17888,구로시장.남구로시장입구,253,204,457,37.4901745492,126.8815338211
17889,에이스테크노타워,373,458,831,37.485021781,126.8941494791
17899,보성운수기종점,409,298,707,37.4901585853,126.8928277373
17900,새마을금고사거리,270,53,323,37.5015032543,126.8586282642
17901,백제약국,268,43,311,37.5048176486,126.8557648896
17902,영화APT,45,46,91,37.4824144309,126.8485710025
17903,천왕역,237,360,597,37.4862992199,126.8386352471
17904,대우자동차정비소,205,158,363,37.4915421241,126.8821344238
17906,고척초등학교,166,145,311,37.499467,126.85815
17907,경남아파트,130,80,210,37.5038737235,126.856354663
17908,남부주유소,32,61,93,37.4823440417,126.8472688866
17909,신도림역2번출구,4023,3882,7905,37.5076372392,126.891883808
17910,구로고대병원후문,660,318,978,37.4934775322,126.8856372215
17911,구로3동현대아파트,55,296,351,37.4869892353,126.8978497443
17912,공구상가,137,198,335,37.498625004,126.860117912
17913,대우아파트,357,204,561,37.5023525197,126.855998104
17917,123전자타운.2001아울렛,231,310,541,37.497292563,126.861808582
17918,성화단지앞,61,80,141,37.5005796345,126.855655416
17920,구로디지털단지입구,228,30,258,37.4829265654,126.9006494039
17922,삼환로즈빌아파트,29,181,210,37.4987023023,126.8566416342
17923,문성골,424,264,688,37.4814923556,126.8999954764
17925,에이스테크노타워,321,423,744,37.4852697727,126.8937835226
17927,구로3파출소,91,165,256,37.4861834877,126.8917920104
17929,구로3동주민센터.삼성래미안아파트,187,186,373,37.4873871314,126.8905621992
17931,구로시장.남구로시장,289,161,450,37.4891691976,126.8911940068
17932,구로구청후문,274,551,825,37.4960354761,126.8880500392
17933,동구로새마을금고,71,61,132,37.4914076166,126.8922617076
17935,구로구청,69,184,253,37.4947318776,126.8894341189
17936,강서수도사업소.민원센터,100,126,226,37.4960920442,126.8908356291
17937,영림중학교,183,87,270,37.4976174721,126.8916635467
17938,구로고.구로도서관,176,157,333,37.4986205714,126.890871533
17940,항아리,65,170,235,37.4988532421,126.8862917876
17942,미성아파트,88,146,234,37.5058198494,126.8774688058
17943,대림1.2차아파트,72,66,138,37.5063468892,126.8782393614
17944,대림5차아파트702동,165,111,276,37.5074731027,126.8798403389
17945,대림5차아파트.신도림주민센터,45,35,80,37.5073421413,126.8813245848
17946,대림6차태영프라자,62,175,237,37.5062202183,126.8830795784
17947,신도림역,292,1891,2183,37.510724,126.890041
17948,현대우성아파트,1,176,177,37.5117462798,126.8854408047
17949,동아1차아파트102동,28,155,183,37.510818,126.884131
17950,동아1차아파트105동,0,18,18,37.5100023717,126.8824062916
17954,1호선구일역,93,290,383,37.4952173233,126.8722148101
17955,금강수목원아파트정문,243,150,393,37.4892057882,126.832990173
17956,고척근린시장,84,437,521,37.5009847732,126.8510128941
17958,구로시장.남구로시장입구,533,206,739,37.4907661875,126.8838670127
17959,구로주공.구일우성APT,183,469,652,37.4913781266,126.8759758863
17960,구로1동주민센터.연예인APT,648,559,1207,37.4929561503,126.8761587458
17961,천왕이펜하우스5단지입구,171,37,208,37.4794432441,126.8421807801
17962,구일고교.구일초등학교,131,9,140,37.4931929794,126.874764638
17963,구로1동주민센터.연예인APT,203,27,230,37.4930726409,126.8759945742
17967,구로디지털단지역,862,514,1376,37.4840575744,126.9018279896
17970,구일초등학교.구일고등학교,138,142,280,37.4932644329,126.8748030066
17971,개봉역,21,308,329,37.4952658606,126.858658118
17972,개봉역,3414,2110,5524,37.4950163829,126.8587648964
17974,KEB하나은행,63,289,352,37.4849571278,126.8958510449
17975,천왕이펜하우스3단지입구,313,75,388,37.4827070928,126.838419099
17982,천왕역2번출구,1554,1528,3082,37.4863641705,126.8383395625
17984,천왕이펜하우스4단지,214,562,776,37.4810441145,126.838628024
17985,천왕이펜하우스6단지,522,594,1116,37.4793763374,126.8406703019
17986,천왕이펜하우스5단지,566,341,907,37.4798931085,126.8403094283
17987,천왕이펜하우스3.4단지,413,99,512,37.4812334148,126.838693244
18001,문성초등학교,1782,1797,3579,37.475363705,126.8986660928
18002,문성초등학교,1414,3472,4886,37.474034,126.89833
18003,금천우체국,4679,2373,7052,37.4689782185,126.8980296913
18004,금천우체국,2333,3879,6212,37.470136,126.898003
18005,말미고개.금천소방서,2395,1195,3590,37.463603277,126.897553768
18006,말미고개.금천소방서,906,3030,3936,37.4648331091,126.8974983974
18007,금천구청.금천경찰서,3268,923,4191,37.4592088301,126.8988721519
18008,금천구청.금천경찰서,839,2641,3480,37.4578405569,126.8993022307
18009,시흥사거리,3405,1196,4601,37.4522224011,126.9015701148
18010,시흥사거리,1421,2729,4150,37.4530892573,126.9011282051
18011,박미삼거리.국립전통예술중고,1865,1047,2912,37.4478432162,126.9032727409
18012,박미삼거리.국립전통예술중고,919,1100,2019,37.449067,126.902663
18013,시흥유통센터,1311,684,1995,37.4401933055,126.9036255139
18014,시흥유통센터,708,1476,2184,37.4409634671,126.9033730997
18101,한일유엔아이아파트,73,1,74,37.4854590227,126.8762259351
18102,디지털3단지.롯데이노베이트,413,264,677,37.484867474,126.8767176309
18103,에이스하이엔드타워5차,424,742,1166,37.4856968409,126.8793253119
18104,디지털3단지.영창실업,266,484,750,37.4832548561,126.8790776714
18105,디지털3단지운동장,312,126,438,37.4821627292,126.8778930341
18106,가산디지털단지역,586,1001,1587,37.4812926525,126.8810424482
18107,가산디지털단지역,1841,512,2353,37.4808039116,126.8814807737
18108,디지털3단지.월드벤처센터,705,188,893,37.4789011065,126.8794436456
18109,디지털3단지.로옴코리아,533,649,1182,37.4796069353,126.8802197911
18110,디지털3단지사거리,321,512,833,37.4766714335,126.880577117
18111,디지털3단지사거리,891,1803,2694,37.4758449905,126.880449538
18112,디지털3단지사거리,2958,1808,4766,37.4757765035,126.8813405986
18113,금천패션아울렛사거리.마리오,1309,1846,3155,37.4782633716,126.8883365872
18114,금천패션아울렛사거리.W몰,1599,1005,2604,37.4776616914,126.8878763257
18115,금천패션아울렛사거리.현대아울렛,669,498,1167,37.4781148494,126.8884894345
18116,디지털단지오거리,532,530,1062,37.4782104216,126.8907157886
18117,디지털단지오거리,442,317,759,37.4782928619,126.8909707678
18118,디지털단지오거리,1912,1213,3125,37.4785564027,126.8934350329
18119,가산초등학교,1117,672,1789,37.4782346236,126.895556221
18120,가산동주민센터.금천글로벌센터,450,326,776,37.4766122299,126.8920986539
18121,가산동주민센터.금천글로벌센터,405,361,766,37.4762442423,126.8927187826
18122,구립가산도서관.두산위브아파트,448,326,774,37.4746216515,126.8938871725
18123,구립가산도서관.두산위브아파트,292,247,539,37.4740996738,126.8945662137
18124,독산사거리,270,488,758,37.4720150736,126.895962451
18125,독산사거리,366,218,584,37.4717836217,126.8965996871
18126,독산주공13단지,138,462,600,37.4568440695,126.8876203011
18127,독산1동한신코아,434,115,549,37.4567130685,126.8882116765
18128,독산주공14단지,10,236,246,37.4611353257,126.886862144
18129,독산주공14단지,251,21,272,37.461371633,126.8870890048
18130,독산근린공원,16,600,616,37.4641790663,126.8844154205
18131,독산근린공원,469,92,561,37.4645544555,126.884406111
18132,독산동우시장.금천50플러스센터,341,708,1049,37.4665936596,126.895025251
18133,독산동우시장.금천50플러스센터,754,445,1199,37.4664171291,126.8954897932
18134,시흥사거리.시흥대교,1231,926,2157,37.454485357,126.8995917841
18135,시흥사거리.금천파출소,86,316,402,37.4542966797,126.8996880795
18136,벽산아파트1단지.호압사입구,200,1282,1482,37.4527573711,126.9207601084
18137,벽산아파트1단지.호압사입구,1313,75,1388,37.4530773052,126.9211862504
18138,벽산아파트5단지,33,338,371,37.4467664432,126.918946809
18139,벽산아파트5단지,443,23,466,37.4463472934,126.918687341
18140,시흥동은행나무.은행나무시장,1330,23,1353,37.4510305202,126.909045481
18141,시흥동은행나무.은행나무시장,95,1965,2060,37.450843,126.909058
18142,은행나무입구사거리,418,20,438,37.4517842218,126.9072078502
18143,은행나무입구사거리,428,1489,1917,37.451855,126.906735
18144,독산한신아파트,394,465,859,37.4569220085,126.889949441
18145,금하마을,328,30,358,37.454121488,126.891508805
18146,독산고개,231,641,872,37.4755154205,126.898464542
18147,독산고개,987,1030,2017,37.4764416088,126.8989324633
18148,독산사거리.한국전력구로금천지사,96,206,302,37.4720755034,126.8981017909
18149,남문시장.청춘삘딩,1025,500,1525,37.47296493,126.8986308908
18150,금천우체국.독산1동주민센터,732,652,1384,37.4701921186,126.8977849964
18151,디지털단지오거리.가산파출소,1273,1400,2673,37.4798243646,126.8883314379
18152,홈플러스금천점,216,367,583,37.468925363,126.897692832
18160,시흥사거리,492,666,1158,37.452863,126.900957
18162,문일고입구,108,61,169,37.4511052777,126.9017298009
18163,문일고입구,147,135,282,37.4508025778,126.9023183704
18164,남서울힐스테이트.국립전통예술고,67,427,494,37.4468088009,126.9033768834
18165,금천폭포공원.천주교시흥성당,193,95,288,37.4477127549,126.9035170378
18166,박미마을,0,263,263,37.4413530192,126.903205922
18167,박미마을.금천고,586,95,681,37.4430092334,126.903941138
18168,기아대교,26,46,72,37.4394878782,126.9029828892
18169,시흥3동주민센터,366,127,493,37.4401670279,126.9036271602
18170,석수역,164,3,167,37.4355241561,126.9033111984
18171,백산초.금천청소년문화의집,235,640,875,37.4487629236,126.9039779583
18172,백산초.금천청소년문화의집,731,419,1150,37.4487264597,126.9043011183
18173,은행나무입구사거리,101,376,477,37.4511117717,126.9057879216
18174,은행나무입구사거리,264,157,421,37.4514263505,126.9059900996
18175,경남아파트,1289,251,1540,37.4536154301,126.9062606441
18176,시흥초등학교.금천구보훈회관,259,931,1190,37.4545675549,126.9058231484
18177,시흥초등학교.금천구보훈회관,712,252,964,37.4553525174,126.905944241
18178,동산교회앞,330,1025,1355,37.4573470454,126.9052838667
18179,동산교회앞,1086,525,1611,37.457026515,126.9056143381
18180,현대시장.시흥4동주민센터,853,1574,2427,37.4596021512,126.9048243385
18181,현대시장.시흥4동주민센터,2164,681,2845,37.4592401831,126.9051695693
18182,남부여성발전센터,583,1556,2139,37.46245548,126.904105597
18183,남부여성발전센터,1201,867,2068,37.4624573826,126.9043527136
18184,독산동정훈단지,1784,3231,5015,37.4655263109,126.9021319938
18185,독산동정훈단지,2403,844,3247,37.464452239,126.9030060331
18186,금천평생학습관.독산초등학교,185,227,412,37.4665939751,126.8994091824
18187,금천평생학습관.독산초등학교,117,527,644,37.466401,126.899878
18188,독산4동주민센터,1307,439,1746,37.4675797473,126.9020379059
18189,독산동성당앞,518,1238,1756,37.4689156821,126.9022258423
18190,독산동성당앞,1049,443,1492,37.4697072815,126.9027437373
18191,독산동쌈지공원,492,1228,1720,37.4712654618,126.9029463536
18192,독산동쌈지공원,1144,498,1642,37.471408536,126.9031982668
18193,독산3동주민센터,429,1386,1815,37.4753270832,126.9033549166
18194,독산3동주민센터,1440,666,2106,37.4758229255,126.9036414631
18195,모두의학교.금천문화예술정보학교,1022,1679,2701,37.4788389714,126.9036963865
18196,모두의학교.금천문화예술정보학교,1065,1086,2151,37.4786589447,126.9039351937
18197,모두의학교.금천문화예술정보학교,2875,3258,6133,37.4799497631,126.9055934267
18198,관악구보훈회관.신림푸르지오,2299,1169,3468,37.4806395906,126.9091389897
18199,독산고등학교,152,233,385,37.4773256419,126.9114634643
18200,독산고등학교,249,247,496,37.4771297022,126.9115032647
18201,금천진로진학지원센터독산센터,289,139,428,37.4767659875,126.9071878356
18202,금천진로진학지원센터독산센터,142,251,393,37.4765368492,126.9073310231
18203,금천우체국.독산1동주민센터,1234,586,1820,37.4697576129,126.8972649852
18204,진도아파트,440,289,729,37.4704156228,126.8924286434
18205,퍼블릭가산,835,415,1250,37.4745287985,126.8860924252
18206,벽산디지털밸리,369,499,868,37.4767219052,126.8852129244
18207,마리오아울렛,90,731,821,37.4785459121,126.8843811699
18208,국민연금공단구로금천지사앞,1012,1392,2404,37.4806919368,126.8840197169
18209,가산디지털단지역,1540,40,1580,37.4811414007,126.8829647271
18210,마리오아울렛,532,206,738,37.4788200801,126.8840084777
18211,벽산디지털밸리,296,422,718,37.476226285,126.8851458502
18212,퍼블릭가산,252,517,769,37.4745060933,126.8859059252
18213,진도아파트,169,310,479,37.4701992555,126.8923170276
18214,현대지식산업센터,291,581,872,37.469904088,126.895544287
18215,가산디지털단지역입구,633,875,1508,37.4814378839,126.8867150826
18216,가산동기점,127,0,127,37.4852270318,126.8752549755
18217,가산동종점,2,90,92,37.4852149815,126.875162385
18218,가산디지털단지역1번출구,1,218,219,37.4817545466,126.8834301518
18219,범일운수종점,2375,19,2394,37.4504126336,126.9117325247
18220,삼익아파트앞,1214,5,1219,37.462545,126.909455
18221,삼익아파트,4,1005,1009,37.462425,126.909395
18222,디지털3단지.영창실업,0,124,124,37.4833271564,126.8789631022
18223,디지털3단지.가산비즈니스센터,72,128,200,37.4796109464,126.8797336317
18224,디지털3단지운동장,1,73,74,37.4825262036,126.8780188781
18225,남문시장입구,124,87,211,37.4712411911,126.9008468962
18226,가산디지털단지역,243,462,705,37.4814101798,126.8831137266
18227,스타밸리앞,1,335,336,37.4811590318,126.8848613006
18228,독산동남문시장,301,1041,1342,37.4737444042,126.9031980805
18229,독산동남문시장,1331,411,1742,37.4733474011,126.9034139964
18232,금빛공원앞,83,138,221,37.4531074327,126.9042968029
18233,금빛공원앞,147,90,237,37.4532796733,126.9044559572
18234,경동택배,75,83,158,37.4502786838,126.9040103136
18235,삼화약국,17,102,119,37.450172246,126.9040551782
18236,대우당약국,10,363,373,37.4507504041,126.9065092253
18237,화인전자산업,45,6,51,37.4508696683,126.9061589552
18238,은행나무로입구,719,43,762,37.4509918205,126.9079435086
18239,시흥대교,508,564,1072,37.4532803888,126.8972682538
18240,가산디지털단지역1호선,1016,327,1343,37.4816756914,126.8811520763
18499,가산한화비즈메트로2차,158,513,671,37.4725342446,126.8821620179
18500,RSM타워.르노코리아서부사업소,198,113,311,37.471015,126.883112
18501,시흥1동공영주차장.금천노인종합복지관,152,134,286,37.451425,126.897101
18502,독산한신코아.한신아파트,213,67,280,37.4565792288,126.8877099959
18503,가산디지털단지역,4016,42,4058,37.4813170887,126.8829559735
18504,벽산3단지,144,139,283,37.4533811369,126.9175043258
18506,성지아파트,90,0,90,37.4511851351,126.8986162093
18507,롯데캐슬1차서문.해가든아파트,366,200,566,37.4600870492,126.8924496344
18508,무지개아파트,519,501,1020,37.4568567561,126.8986616803
18510,벽산3단지앞,20,1,21,37.4529820233,126.9169114156
18511,독산역,2068,1378,3446,37.4670001721,126.889226261
18512,문성중학교,55,17,72,37.4756246737,126.905866831
18513,홈플러스.문일중고입구,514,31,545,37.4509197575,126.9002034735
18514,금천현대아파트,510,350,860,37.4627137448,126.8913946671
18515,독산주공1319동,113,0,113,37.4584615691,126.8876303149
18517,아톰주식회사,46,168,214,37.4707730549,126.8829837206
18518,호남슈퍼,39,1,40,37.452221692,126.9151830871
18519,남문교회,52,34,86,37.4737106004,126.9059678481
18522,문일고입구,81,111,192,37.4511228214,126.9016533505
18524,탑동초등학교.청담종합사회복지관,41,1,42,37.4520537227,126.9144662534
18525,태영빌라,32,43,75,37.4718196531,126.9063091413
18526,무지개아파트,397,1004,1401,37.4570880833,126.8985727429
18527,두산초등학교,76,49,125,37.4664902534,126.8916463628
18528,독산주공14단지,166,2,168,37.4593983202,126.8858271569
18530,온누리아파트,175,284,459,37.4734920619,126.8867089769
18531,어울샘.동산중앙교회,41,13,54,37.4520508795,126.9118509343
18532,구민문화체육센터,249,108,357,37.4701790336,126.906683145
18533,독산현대아파트.금천50플러스센터,68,208,276,37.4671220994,126.8944524695
18534,시흥유통상가.금천고,52,220,272,37.4432485828,126.9035255453
18535,에이스하이엔드타워클래식,430,734,1164,37.4735790442,126.8893157842
18536,새마을금고,43,26,69,37.4513577639,126.9104910601
18537,해찬아파트,60,49,109,37.4682464727,126.9070812349
18538,진도3차아파트,80,41,121,37.4684083858,126.8939000889
18540,박미마을,68,111,179,37.440931611,126.9031686259
18541,가산테라타워,396,487,883,37.4739704302,126.8899360299
18542,시흥동은행나무,971,247,1218,37.4514540858,126.9079384209
18543,시흥사거리.대명시장,1246,862,2108,37.454725,126.901265
18544,구립독산도서관,139,90,229,37.4671936204,126.9077732858
18545,유창슈퍼,139,34,173,37.4685449644,126.8924720236
18548,구립가산도서관.두산위브아파트,474,473,947,37.4735235187,126.8924060994
18549,은행나무입구사거리,280,157,437,37.4526253772,126.9054638874
18550,시흥초등학교.시흥1동주민센터,214,260,474,37.4535492973,126.9035830113
18552,산기슭공원,133,57,190,37.4639767337,126.9067112027
18553,독산역,1903,1524,3427,37.4660500537,126.8898143938
18554,진도2차아파트,226,37,263,37.4701338936,126.8917891479
18556,시흥초등학교.금빛공원,207,384,591,37.4533678073,126.9042399555
18557,삼익APT.금강APT,281,91,372,37.4627729841,126.9068259879
18558,두산로입구,71,70,141,37.4718560099,126.8872683557
18559,빅마켓.청광아파트,87,49,136,37.470518615,126.8937184762
18560,대륭테크노2차,165,120,285,37.468945,126.884404
18561,두산위브아파트정문,367,187,554,37.474880117,126.8938818954
18562,남부여성발전센터,176,87,263,37.4627815001,126.9052548518
18564,길상마트,135,80,215,37.4720209133,126.8938893297
18565,대륭테크노타운,179,84,263,37.4694900501,126.8837224396
18566,가산동주민센터.금천글로벌센터,462,207,669,37.4760757114,126.8936891244
18569,대륭테크노타운19차,99,118,217,37.4742699142,126.88166688
18570,에이스태세라타워,386,189,575,37.472455257,126.8824730566
18571,고원약국,321,189,510,37.4766992467,126.8947462752
18572,꿈나래어린이집,12,68,80,37.4548280098,126.8972130692
18573,우방아파트.범일운수종점,426,642,1068,37.4499835235,126.9132502452
18577,가산초교,240,143,383,37.4770824972,126.8965101242
18581,STXV타워,21,232,253,37.476776835,126.883254362
18582,독산고개입구,261,243,504,37.4759060291,126.8977000347
18583,벽산아파트5단지,1110,2637,3747,37.4500584604,126.921018114
18585,빅마켓,184,83,267,37.4700299236,126.8954116204
18586,한신IT타워,33,80,113,37.4799300143,126.8862424501
18587,가산동주민센터,136,95,231,37.4769075492,126.8909586486
18588,SG세계물산,187,90,277,37.4763040335,126.8894662101
18589,가산로데오거리,77,33,110,37.4783936947,126.887811468
18590,호압사입구,442,588,1030,37.4517227734,126.9205758327
18592,이앤씨드림타워7차,50,51,101,37.4798002515,126.8866638518
18593,LG전자.W몰,19,166,185,37.4769117974,126.8886451685
18594,가산디지털단지역1호선앞,556,282,838,37.4809146873,126.8814206702
18595,금천육교앞,1,16,17,37.4554158552,126.8915243807
18596,벽산1단지입구,631,309,940,37.4501429977,126.9198492816
18598,시흥모터스,386,466,852,37.4705765464,126.8894417351
18600,문성초등학교,84,28,112,37.473974397,126.8981181055
18601,섭리의집,26,11,37,37.4463421176,126.908761999
18602,섭리의집,4,20,24,37.4462280579,126.9087889887
18603,가산디지털단지역,325,533,858,37.4802047061,126.88331005
18617,KCC웰츠밸리,5,161,166,37.4835533313,126.8798436042
18618,독산고개입구,173,345,518,37.4771618769,126.8984628392
18639,벽산6단지입구,156,120,276,37.4499598725,126.9181165746
18643,독산역,444,290,734,37.4663102404,126.8876524834
18644,독산역,841,395,1236,37.4665025176,126.8878906214
18657,남부여성발전센터앞,187,663,850,37.4626344076,126.90531765
18658,남부여성발전센터앞,141,73,214,37.4628027901,126.9051582923
18688,에이스하이엔드10차,139,75,214,37.4684956743,126.886968628
18689,대륭테크노타운17차,13,184,197,37.468514365,126.8866426914
18699,금천패션아울렛사거리.마리오,218,130,348,37.4778165267,126.8874417824
18708,범일운수종점,3,1017,1020,37.4502773846,126.9116027167
18740,한울중학교,177,146,323,37.462674,126.907201
18741,한울중학교,0,273,273,37.462522,126.907302
18755,서울시립금천청소년센터,4,84,88,37.44832,126.916104
18756,서울시립금천청소년센터,54,1,55,37.448241,126.915964
18757,탑스빌아파트.벽산6단지아파트,24,2,26,37.449201,126.916113
18763,가산초교,172,311,483,37.4771655122,126.8964859843
18764,동일여고.금천사이언스큐브,279,187,466,37.449982,126.916816
18772,두산로입구,55,64,119,37.4719100442,126.8870629531
18776,석수역,1306,1575,2881,37.4348585994,126.9027764439
18777,석수역,1922,912,2834,,
18782,디씨아이,9,228,237,37.483105,126.877977
18783,벽산디지털밸리2차,85,258,343,37.4839499569,126.8773484856
18784,고원약국,197,435,632,37.4768694128,126.8946699691
18785,안천중학교,86,96,182,37.45865644,126.8873428503
18786,제일교회,572,293,865,37.450134,126.913499
18787,서울디자인직업전문학교.청년취업사관학교,45,56,101,37.4723731984,126.895861725
18788,대륭테크노타운8차,182,187,369,37.4848785249,126.8768957838
18790,가산동주민센터.금천글로벌센터,161,473,634,37.4761462878,126.893528898
18791,범일운수종점,302,301,603,37.450593,126.911085
18792,벽산디지털밸리6차,272,31,303,37.4856403517,126.8791529742
18794,두산위브아파트정문,274,259,533,37.4748870849,126.8936139249
18795,독산한신아파트,36,13,49,37.4571907673,126.889287077
18796,길상마트,47,80,127,37.4720667742,126.8937829891
18797,가산디지털단지역1호선,1047,303,1350,37.4809685316,126.8812832163
18798,한국건설생활환경시험연구원,26,94,120,37.4833144645,126.880092378
18800,빅마켓.청광아파트,14,72,86,37.4705095093,126.8936133461
18801,롯데캐슬2차,288,197,485,37.4580268804,126.8934387396
18802,문일고입구,13,147,160,37.4509358821,126.9022458595
18803,구립가산도서관.두산위브아파트,364,364,728,37.4736405707,126.8923053067
18804,롯데캐슬2차,213,248,461,37.4576642489,126.8934675106
18805,진도2차아파트,25,123,148,37.4702475167,126.8917002882
18806,한진택배,236,230,466,37.4750869917,126.8810805476
18807,가산테라타워,613,385,998,37.4741297901,126.8902581746
18808,금천구종합청사.금천구청역,790,594,1384,37.456079,126.895347
18809,유창슈퍼,12,87,99,37.4684945707,126.8927663012
18812,에이스하이엔드타워클래식,568,177,745,37.4736059632,126.8891970422
18814,시흥모터스,91,101,192,37.4704163658,126.8891734892
18815,홈플러스.문일중고입구,0,317,317,37.4509297326,126.8996929387
18816,진도3차아파트,66,63,129,37.4685947359,126.8937008503
18817,대륭테크노타운,40,154,194,37.469837,126.883396
18818,온누리아파트,173,91,264,37.4736650982,126.8874164194
18820,성지아파트,0,38,38,37.4512627351,126.8987381748
18821,독산현대아파트.금천50플러스센터,124,75,199,37.4670373288,126.8943779746
18822,대륭테크노2차.12차,24,71,95,37.4688296905,126.8847974797
18824,시흥1동공영주차장.금천노인종합복지관,0,30,30,37.451388,126.896631
18825,두산초등학교,25,73,98,37.4666374319,126.8916076535
18826,교학사,1,87,88,37.4692410639,126.8862111673
18828,홈플러스금천점,391,249,640,37.4694911309,126.8975479886
18829,독산역,146,386,532,37.4660003578,126.8896697625
18833,서울디자인직업전문학교.청년취업사관학교,153,70,223,37.4723792747,126.8955994178
18834,가산디지털단지역,36,3208,3244,37.4812885297,126.8831127854
18836,새마을금고,24,38,62,37.4512100674,126.9105225388
18838,금천구종합청사.금천구청역,1994,275,2269,37.4561717653,126.8945113914
18839,어울샘.동산중앙교회,6,44,50,37.451830181,126.9117005818
18840,삼익APT.금강APT,115,266,381,37.4628624021,126.9070673867
18841,탑동초등학교.청담종합사회복지관,4,55,59,37.4518750005,126.9140493801
18842,산기슭공원B,24,251,275,37.4639317515,126.9068039573
18843,안천초등학교,75,105,180,37.4575384027,126.8881256699
18844,호남슈퍼,0,28,28,37.4522114153,126.9157184402
18845,구립독산도서관,85,234,319,37.4672144587,126.9079179668
18847,벽산3단지앞,0,24,24,37.4530226799,126.917069597
18848,해찬아파트,33,176,209,37.4682411948,126.9072451691
18850,구민문화체육센터,113,227,340,37.4701485004,126.906815459
18851,한일유엔아이,226,109,335,37.4855289741,126.8760098705
18852,태영빌라,8,73,81,37.471726987,126.906495804
18853,남문교회,15,120,135,37.4736343111,126.9060943201
18854,문성중학교,6,107,113,37.4756346993,126.9060092799
18856,난곡중학교,552,315,867,37.477082032,126.9110143579
18857,산기슭공원,15,0,15,37.4638496339,126.906717753
18858,하안주공1317동,49,0,49,37.4576070259,126.8882725165
18859,금천현대아파트,283,479,762,37.4632862867,126.8909546212
18860,롯데캐슬1차서문.해가든아파트,317,291,608,37.4599253406,126.8922978284
18861,금빛공원,148,309,457,37.4527253788,126.9051351851
18863,시흥사거리.대명시장,762,695,1457,37.4547643438,126.9018203929
18864,시흥동은행나무,1110,884,1994,37.4506837601,126.909262913
18865,시흥2동주민센터.동일여고,443,424,867,37.449962,126.914014
18866,두산어린이공원,615,456,1071,37.4736278101,126.8941391855
18867,금천구종합청사.금천구청역,918,1822,2740,37.456374558,126.8954899439
18868,두산어린이공원,449,508,957,37.473619,126.894257
18869,롯데캐슬3차,147,101,248,37.4599718531,126.8962925927
18871,롯데캐슬1차정문.해가든아파트,5,134,139,37.4608040223,126.894248153
18872,롯데캐슬1차동문,164,192,356,37.4591670967,126.8964634478
18873,롯데캐슬1차정문.해가든아파트,13,18,31,37.4610024925,126.8940923871
18959,백운한비치.금광포란재아파트,14,35,49,37.4512655226,126.9117159329
18960,시흥5동주민센터,67,48,115,37.4513528541,126.9087037456
18961,삼성산자연공원.삼성체육공원,12,20,32,37.4548245367,126.9094952807
18962,시흥아파트앞,4,17,21,37.4564310534,126.9081188294
18963,신흥초등학교,6,38,44,37.4593571341,126.9082692514
18964,한빛무궁화아파트,0,65,65,37.4604705729,126.9079251069
18967,금천폭포공원,104,25,129,37.447211891,126.9037052975
18968,영일빌라,22,36,58,37.4473501248,126.9064018284
18969,시흥계곡앞,14,27,41,37.4466449121,126.9103494029
18970,시흥5동성당,21,31,52,37.4483281695,126.9115228397
18972,한울중학교앞,166,2,168,37.4623255009,126.9077736775
18973,한빛무궁화아파트,52,1,53,37.4606136948,126.9079227192
18974,신흥초등학교,25,4,29,37.4593209089,126.9081362324
18975,시흥아파트앞,7,3,10,37.4566174024,126.9078868775
18976,삼성체육공원.삼성산자연공원,23,16,39,37.454675697,126.9092908701
18977,시흥5동주민센터,73,60,133,37.4516321,126.9085768142
18978,금광포란재.백운한비치아파트,76,19,95,37.4511323266,126.9113929457
18979,관악우방아파트,105,38,143,37.4499083635,126.912257908
18980,시흥5동성당,21,16,37,37.4486202245,126.9116502129
18981,시흥계곡앞,39,16,55,37.4469398097,126.9103556871
18982,영일빌라,24,26,50,37.4475057487,126.9060636976
18983,금천문화원.국립전통예술중고,21,95,116,37.4464155627,126.9045526814
18984,금천고등학교,36,80,116,37.4447220355,126.9047098297
18985,시흥3동공영주차장앞,55,90,145,37.4428790713,126.9044714442
18987,기아대교앞,0,30,30,37.4379594347,126.9027904886
18988,석수역,121,249,370,37.4349735461,126.9028582142
18989,석수역,111,10,121,37.4350042057,126.9033005669
18992,시흥사거리,36,115,151,37.4526734399,126.9016076387
18993,안양천로입구,2,10,12,37.4524815093,126.8931359029
18994,남문시장입구.청춘삘딩,35,93,128,37.4712256795,126.9000105994
18999,7호선가산디지털단지역,170,1014,1184,37.4795024072,126.8820730575
19001,문래동남성아파트,625,1092,1717,37.511828,126.893705
19002,문래동남성아파트,699,1245,1944,37.511202,126.892312
19003,남부지방법원등기국.구로세무서,2278,2481,4759,37.5144838858,126.9011873627
19004,남부지방법원등기국.구로세무서.에이스하이테크시티,2304,2421,4725,37.5140403403,126.8997458122
19005,영등포역,2519,2312,4831,37.5158657465,126.90509208
19006,영등포역,2625,3762,6387,37.516587933,126.9070303774
19007,여의도환승센터,3141,2080,5221,37.5255225645,126.9242437485
19008,여의도환승센터,3047,3949,6996,37.526058119,126.9242066145
19009,서울영림초등학교,2110,2904,5014,37.4871457304,126.904836994
19010,강남성심병원.대림성모병원,3812,3116,6928,37.490982282,126.9080013569
19011,경남아너스빌아파트,992,2048,3040,37.4955867471,126.9115745553
19012,보라매공원,933,1715,2648,37.4970612966,126.9163819913
19013,보라매역.동작세무서,2612,1772,4384,37.4989718729,126.9202813984
19014,서울지방병무청,1182,1624,2806,37.5043933307,126.9219621952
19015,대방역,819,1221,2040,37.5126573835,126.9248245911
19017,여의도환승센터,1116,2407,3523,37.5253174941,126.924099718
19101,대성병원,158,324,482,37.5122856218,126.9099270612
19102,영등포공원.영등포문화원,381,325,706,37.5138042027,126.9114184502
19103,영등포공원.영등포문화원,265,331,596,37.5149507944,126.9119431216
19104,영등포시장역3번출구,1374,1280,2654,37.5218552056,126.9051989835
19105,영등포시장,769,1522,2291,37.5197345469,126.9066538832
19106,영등포로터리,1742,3382,5124,37.519063,126.909852
19107,영등포로터리,2008,1044,3052,37.5189144362,126.909290557
19109,영등포시장,908,742,1650,37.5194457626,126.9064498646
19112,경방타임스퀘어.신세계백화점,6303,2859,9162,37.5175082319,126.9062396031
19114,영등포역,765,470,1235,37.5170626873,126.9090467727
19117,경방타임스퀘어.신세계백화점,1980,3086,5066,37.51849,126.905437
19118,김안과병원,1803,2879,4682,37.5200710672,126.9030257176
19119,김안과병원,2991,2263,5254,37.5204160307,126.9028340777
19120,영등포시장역4번출구,1287,1541,2828,37.521318,126.904785
19121,신화병원,1068,959,2027,37.5245305326,126.9051548683
19122,신화병원,798,1041,1839,37.5248948852,126.9055402111
19123,영동초교,350,169,519,37.5251590221,126.9068194848
19124,영동초교.영등포평생학습관,111,377,488,37.5254970147,126.9073622386
19125,삼환아파트,1371,1608,2979,37.529082,126.905597
19126,당산푸르지오아파트,2178,1202,3380,37.529032,126.905958
19130,KBS,540,201,741,37.5246535111,126.9181131549
19131,국회의사당,1450,786,2236,37.5294106436,126.9178873435
19132,국회의사당역.KB국민은행,1216,1238,2454,37.5284793584,126.9180683792
19133,국회의사당역5번출구,2545,2113,4658,37.5279936051,126.9175806125
19134,양평동한솔아파트,236,496,732,37.544408,126.89024
19136,여의도순복음교회,1253,1521,2774,37.5309108798,126.924753069
19137,여의도순복음교회,945,619,1564,37.5316913231,126.9229307724
19138,여의도공원9번출입구,826,678,1504,37.5295296763,126.9278920215
19139,여의나루역1번출구,1532,1154,2686,37.5274578013,126.9314780831
19140,여의나루역2번출구,1414,1207,2621,37.527387513,126.9320237959
19141,여의도중학교,183,263,446,37.5244095933,126.9356353384
19142,여의도중학교,227,355,582,37.5244595611,126.9359647299
19143,63빌딩.가톨릭대학교여의도성모병원,2038,1488,3526,37.5194039511,126.9376069307
19144,63빌딩.가톨릭대학교여의도성모병원,1562,1320,2882,37.5191618125,126.9377092728
19145,시범아파트,782,536,1318,37.5210428541,126.9351904947
19146,시범아파트.대교아파트,982,1140,2122,37.5210349091,126.9344292065
19147,여의동주민센터,421,300,721,37.5187056997,126.9342191488
19148,여의동주민센터,264,655,919,37.518518604,126.933973282
19149,진주아파트,735,1030,1765,37.5192462487,126.9323106146
19150,KBS별관,2752,1736,4488,37.5191952505,126.9315858844
19151,샛강역3번출구,1493,1440,2933,37.51810879,126.9303001713
19152,여의도공원1번출입구,689,693,1382,37.523605,126.920262
19153,샛강역1번출구.여의도자이,2089,4629,6718,37.5188169961,126.9272111083
19154,샛강역4번출구.여의도자이,1926,1357,3283,37.5186769123,126.9267431365
19155,여의도역6번출구,4847,1858,6705,37.5206144242,126.9249200821
19156,여의도역5번출구,2856,5277,8133,37.5213350582,126.9248852134
19157,한국거래소,1625,2394,4019,37.5233529273,126.927068407
19158,한국거래소,1884,637,2521,37.5236693289,126.9270706296
19159,삼부아파트,1606,1714,3320,37.5251264453,126.9301171862
19160,여의도공작아파트,1120,1155,2275,37.5259920176,126.9309977447
19161,한국경제인협회,1894,3368,5262,37.5218906273,126.9188836862
19162,당산동진로아파트,1285,1465,2750,37.5213255961,126.8968775442
19163,당산동진로아파트,1929,2066,3995,37.5210022006,126.8969911224
19164,필립메디컬센터,254,338,592,37.5206987975,126.8952459024
19165,양남사거리,791,1117,1908,37.522120309,126.8917785954
19166,영등포교보생명,1608,1164,2772,37.5217213888,126.8920699266
19167,현대아파트,342,808,1150,37.5230559785,126.8961601415
19168,영등포구청,1202,1204,2406,37.5262213165,126.8969364269
19169,영등포구청,1949,1206,3155,37.5254134463,126.8963808906
19171,당산동삼익아파트,273,401,674,37.5281841492,126.8959624246
19172,당산역,3539,1993,5532,37.5347289688,126.900525529
19173,당산119안전센터.당산역,1378,1399,2777,37.534925387,126.8994545764
19174,당산역삼성래미안아파트,2906,2242,5148,37.533022,126.903388
19175,당산역삼성래미안아파트,1241,2328,3569,37.5331897116,126.9035824119
19176,당산역2번출구,1267,1894,3161,37.5348629874,126.9024102445
19177,당산역,816,381,1197,37.5328062968,126.9008638878
19178,당산역,94,526,620,37.5328262574,126.9013030592
19181,당산삼성아파트,439,600,1039,37.5288298776,126.8981321136
19182,당산유원제일1차아파트,696,574,1270,37.5287170417,126.8976084675
19183,서울영등포우체국,207,230,437,37.5284831639,126.8960123192
19184,도림동자치회관,364,504,868,37.509542599,126.9074865803
19186,도림새마을금고,1177,467,1644,37.5084285334,126.9003200973
19187,도림새마을금고,570,1147,1717,37.5082587788,126.9000627119
19188,신길가마산로교차로,227,68,295,37.5065149631,126.9111162984
19192,문래역3번출구,2285,390,2675,37.5192330216,126.8942227741
19193,문래역3번출구,511,2459,2970,37.5190642533,126.8944124856
19195,국화아파트,3,39,42,37.5156543708,126.8923755969
19196,현대6차아파트,6,501,507,37.518198,126.884328
19197,문래롯데캐슬,823,7,830,37.5184108268,126.8845693693
19198,문래중학교,21,685,706,37.5197635659,126.8847214778
19199,문래중학교,670,7,677,37.5199519089,126.8849459462
19200,문래동국화아파트,22,31,53,37.515779821,126.8913940766
19201,서울지방노동위원회.대림아파트,64,1,65,37.5168588434,126.8892688603
19202,양평1동주민센터,896,819,1715,37.5226964057,126.8882760563
19203,양평신동아아파트,1083,994,2077,37.5224802186,126.8873567458
19204,관악고등학교,910,1183,2093,37.5229942584,126.8840591861
19205,관악고등학교,1231,1074,2305,37.523161734,126.8848486189
19206,당중초등학교,133,444,577,37.526998,126.890987
19207,당중초등학교,647,213,860,37.5269046476,126.8912931843
19208,오산당요양병원,113,277,390,37.5238199685,126.8902116552
19210,한신아파트.선유도역,1289,1155,2444,37.5383576111,126.8932341248
19211,선유도역1번출구.한신아파트,742,1736,2478,37.5380360687,126.8932768999
19212,선유도역.롯데웰푸드,1383,667,2050,37.5371966691,126.8948754336
19213,선유도역.롯데웰푸드,497,1231,1728,37.53714501,126.8955567144
19214,양평한신아파트.선유도공원입구,764,403,1167,37.5416485864,126.8944278421
19215,영등포아리수정수센터,1932,2490,4422,37.547524111,126.8841131456
19216,양평한신아파트.선유도공원입구,447,856,1303,37.5420309939,126.894662988
19217,안양천입구,2036,1580,3616,37.547469263,126.8834636891
19218,양평동한솔아파트,1030,531,1561,37.5439165302,126.89034721
19219,신풍역3번출구,435,788,1223,37.4999832177,126.9080213793
19220,선유도역2번출구.당산초등학교,448,442,890,37.5388210381,126.8945006101
19221,영등포세무서.선유고등학교,158,511,669,37.5342386203,126.8962877577
19222,영등포세무서.선유고등학교,539,88,627,37.5344087772,126.8967008179
19223,선유중학교,260,358,618,37.532051991,126.8945217072
19224,선유중학교,301,196,497,37.530961,126.894106
19225,신길역1번출구,2432,3742,6174,37.516815,126.916956
19226,신길1동새마을금고,1779,1697,3476,37.5136409433,126.9200351486
19227,신길1동새마을금고,1475,1276,2751,37.5140830291,126.9195131812
19228,대신시장,2460,1329,3789,37.5118665222,126.9164620153
19229,대윤병원,829,543,1372,37.5145262639,126.9181496713
19230,대신시장,1077,1439,2516,37.5120674779,126.9162973886
19231,영등포농협.신길2동새마을금고,925,828,1753,37.5113759569,126.9131764145
19232,우신초등학교,651,1297,1948,37.509355,126.910608
19233,포레나신길아파트,679,1253,1932,37.5034133163,126.9101490426
19234,성락교회,752,770,1522,37.5045853868,126.902587137
19235,성락교회,663,427,1090,37.5047495305,126.9028724835
19236,도림동자치회관,340,225,565,37.5092940284,126.9076717402
19238,우신초등학교,1049,777,1826,37.50958,126.910838
19239,신길힐스테이트클래시안아파트,1934,1389,3323,37.5049891763,126.9108112918
19240,신길동홍어거리,995,978,1973,37.5108205742,126.9114719863
19241,신풍역.백악관웨딩문화원앞,673,1491,2164,37.5014308216,126.9097782155
19242,신길5동주민센터,639,453,1092,37.5009593596,126.9053855538
19243,신길5동주민센터,333,432,765,37.5010548825,126.9049278277
19244,신풍역,94,227,321,37.5000120734,126.9068971154
19245,영등포농협도림로지점.우리시장,373,297,670,37.4981782693,126.9045627731
19246,영등포농협도림로지점,297,398,695,37.4986738862,126.9045757143
19247,태양의집.KT대방지사,1241,752,1993,37.4950914986,126.9088076812
19248,신길주유소,649,656,1305,37.4984011732,126.9083965467
19249,신풍역.백악관웨딩문화원앞,1635,926,2561,37.5013238443,126.9100850037
19251,래미안에스티움북문,8,0,8,37.501245,126.916458
19252,도림초등학교,64,23,87,37.507364,126.90639
19253,대방역,360,263,623,37.5127693585,126.9237905553
19255,공군호텔,2269,3479,5748,37.5098706868,126.9240536702
19256,서울지방병무청,155,424,579,37.5051747159,126.9221593231
19257,대방초등학교,23,111,134,37.5023841407,126.9210085488
19258,태양의집,823,1053,1876,37.4961497424,126.9082409755
19260,대림동우체국,216,262,478,37.4894382828,126.9054525686
19261,흰돌교회,220,282,502,37.4913161222,126.9029549092
19262,대동초등학교,181,385,566,37.4941811504,126.9006322883
19264,대림역12번출구,877,848,1725,37.4925216728,126.8966231256
19265,대동초등학교.명지성모병원,653,636,1289,37.4942998541,126.8992448194
19266,대동초등학교,547,208,755,37.4936614284,126.9006611965
19267,흰돌교회,176,231,407,37.4905430612,126.9032572847
19268,대림동우체국,172,266,438,37.4896278351,126.9047297114
19269,대림동우성아파트,590,568,1158,37.495996096,126.9020385312
19270,대림역9번출구,777,1217,1994,37.49288,126.896585
19271,대동초등학교.명지성모병원,577,786,1363,37.4941715864,126.8986961015
19272,대림동우성아파트,1038,506,1544,37.4965119007,126.9023480929
19273,YDP미래평생학습관,379,110,489,37.5037864503,126.8955055827
19274,대림동현대3차아파트,25,73,98,37.504569,126.89654
19275,신영초등학교,30,12,42,37.5016268639,126.8971376372
19276,한국방송통신대,28,87,115,37.5030128151,126.8961720728
19277,선유도공원,90,166,256,37.542245,126.902595
19278,선유도공원,59,197,256,37.542025,126.902915
19279,신길역5호선,1739,876,2615,37.51855816,126.9148309222
19280,국회의사당,777,1633,2410,37.5306422804,126.919153684
19281,산업은행본점,274,331,605,37.5279671701,126.9208525949
19282,더현대서울,2422,1390,3812,37.5250045778,126.9281836353
19283,유진투자증권,1170,1663,2833,37.5255310516,126.9269899252
19284,파크원타워.LG트윈타워,3231,2645,5876,37.5270921709,126.9272061799
19285,신길파크자이아파트,316,74,390,37.5050599658,126.9132459329
19286,여의도한양아파트,32,210,242,37.5209203503,126.9320647349
19287,하나은행여의도지점,407,581,988,37.5213281189,126.9311455901
19288,여의도수정아파트,27,176,203,37.5224629956,126.9304856028
19289,신풍역6번출구,200,149,349,37.5003168268,126.9104304773
19290,여의도역3번출구,964,561,1525,37.523355,126.923253
19291,영진시장.신길새마을금고,187,119,306,37.5001550045,126.9154974818
19292,문래우체국.문래예술공단,145,310,455,37.5142585924,126.8951938185
19293,문래우체국.문래예술공단,196,274,470,37.5141627048,126.8947765295
19294,대림3동주민센터,179,168,347,37.4978471953,126.8988103256
19296,대방역,41,127,168,37.512907,126.923495
19297,신길가마산로교차로,1210,1409,2619,37.5063691885,126.9109089196
19298,대길초등학교,107,30,137,37.4989132022,126.9122243497
19299,미보빌딩,53,40,93,37.4984175455,126.9167140863
19300,신길역1호선,1159,1026,2185,37.5167591036,126.9166368877
19301,신길보라매SK뷰아파트,347,160,507,37.504066,126.919256
19302,현대아파트,60,28,88,37.5229871573,126.8957767054
19303,여의도순복음교회,744,1751,2495,37.5300112247,126.9241543204
19304,래미안에스티움,142,100,242,37.5001649059,126.912773792
19305,문래역.문래자이아파트,434,593,1027,37.5166249423,126.8945855945
19306,대방역,1133,905,2038,37.513747861,126.9265562252
19307,대방역,1896,1312,3208,37.5135876259,126.9259750871
19309,대길초등학교,39,66,105,37.4985891868,126.9145708821
19310,대방천사거리,224,222,446,37.498862,126.919402
19311,대방천사거리,22,36,58,37.4984887613,126.9197990982
19312,대림코오롱아파트,272,259,531,37.5069073568,126.8942967179
19314,새길어린이집.신풍역3번출구,69,38,107,37.4993499174,126.9074086857
19315,새길어린이집.신풍역3번출구,106,72,178,37.4995770969,126.9069956306
19316,영문초등학교,90,810,900,37.520197,126.887835
19317,영문초등학교,1088,112,1200,37.520047157,126.887957615
19318,문래역1번출구,812,374,1186,37.5166312538,126.8942560751
19319,양화중학교.홈플러스,89,186,275,37.5193690011,126.8952832738
19320,기계회관,120,136,256,37.5290992579,126.9226786966
19321,신동아아파트,57,121,178,37.4980725102,126.8946317256
19322,신영초교,38,148,186,37.4989309377,126.8963032658
19323,우성5차아파트,451,518,969,37.5076045335,126.9032049179
19324,우성5차아파트,623,504,1127,37.5073405785,126.9030359596
19325,현대3차성원아파트,292,132,424,37.5042942428,126.8966160437
19327,대림3동사거리.명지춘혜병원,179,247,426,37.5004765901,126.8976368647
19328,현대2차아파트,84,162,246,37.5033510946,126.8952038884
19329,성원아파트.한국상하수도협회,222,190,412,37.5025756986,126.8967569528
19330,베뢰아국제대학원대학교,408,418,826,37.5010729304,126.8989671275
19332,성원아파트입구,113,157,270,37.5049661894,126.8979949457
19333,신길우성1차.건영아파트,259,264,523,37.5060560163,126.8995852828
19334,건영아파트,99,112,211,37.5063544176,126.9008515938
19336,신길바다마을아파트.보라매sk뷰,12,0,12,37.502859,126.916049
19337,성애병원,0,29,29,37.5115127712,126.9230916275
19338,신길보라매sk뷰.바다마을아파트,2,10,12,37.5029041708,126.9161719065
19341,우성2차아파트,104,115,219,37.499257657,126.9104508793
19346,보라매역4번출구,74,234,308,37.4998464533,126.9193169475
19347,신길새마을금고.영진시장,129,197,326,37.4998909378,126.9170658543
19350,신길광장공원,1,27,28,37.4999373494,126.9039926579
19351,대성아파트.건영아파트후문,96,61,157,37.5032308592,126.9003306899
19352,대성유니드아파트,16,14,30,37.5008368106,126.9027078981
19353,래미안에스티움북문,3,13,16,37.5014200855,126.9166259326
19354,건영아파트후문,40,78,118,37.5026893321,126.900562942
19357,대림동코오롱아파트,299,310,609,37.5076981532,126.8945682049
19358,문래동종점,0,175,175,37.5156735527,126.8864003638
19359,문래동시점,411,3,414,37.5155477112,126.8867116154
19360,KT&G영등포지사.문래동종점,0,144,144,37.5154220985,126.8872632303
19361,신길1차우성아파트,91,14,105,37.5058715996,126.8998713446
19362,보라매역.5번출구,234,87,321,37.5000416572,126.9189129834
19364,영등포동.영등포푸르지오아파트,115,66,181,37.5101417818,126.9046723569
19365,우신초교앞사거리,45,194,239,37.5108880833,126.9100169726
19367,도림초교사거리,256,197,453,37.508301905,126.905380142
19386,고추말,11,50,61,37.511947326,126.9062761886
19389,코끼리유통,77,184,261,37.505854886,126.9070387375
19390,대영고등학교.신길센트럴아이파크,80,110,190,37.504783,126.904153
19392,동양볼링장,0,111,111,37.5167682627,126.8884241986
19393,보라매공원입구,54,50,104,37.4985706187,126.9165753842
19402,현대2차아파트후문,407,58,465,37.5030100625,126.8940864024
19403,도림초교사거리,140,104,244,37.509135311,126.9051712916
19404,도림초등학교,13,36,49,37.5069671974,126.9064944778
19405,고추말,42,17,59,37.511958456,126.9061093409
19406,SG메디피움,7,11,18,37.505080073,126.9047285685
19407,도림사거리,372,304,676,37.5070505173,126.9012712286
19416,기림약국,37,27,64,37.4997728852,126.9008725167
19418,신길광장공원,20,14,34,37.4999670445,126.9045015227
19423,코사마트,8,20,28,37.4984017729,126.9020269071
19424,성락빌딩,23,21,44,37.500908,126.89948
19425,우리은행,23,31,54,37.4974634886,126.9032579405
19427,두산위브진주아파트,285,2,287,37.5164206155,126.885309553
19428,현대3차아파트,2,163,165,37.516298,126.884898
19429,CM병원,149,110,259,37.5183527655,126.9027079039
19430,대방역,1733,1413,3146,37.513045,126.924159
19434,타임스퀘어.영등포소방서,240,408,648,37.5180119835,126.9045916481
19435,당산신동아파밀리에,40,60,100,37.5196779796,126.9008141712
19436,영등포청과시장,65,34,99,37.5236699556,126.9018127545
19437,영등포청과시장,44,132,176,37.522484979,126.9017747101
19438,서울시립청소년성문화센터,171,69,240,37.5251517776,126.9023142827
19439,서울시립청소년성문화센터,89,183,272,37.5246798544,126.9023884969
19450,한강아파트,196,151,347,37.5277478405,126.9034083876
19451,빅마켓영등포점,193,211,404,37.5280663072,126.903872998
19452,당산센트럴아이파크아파트,53,92,145,37.5300905669,126.9043580631
19453,영등포농협당산역지점,9,83,92,37.5308155244,126.9049656612
19454,신풍시장,278,115,393,37.5057447122,126.9101667964
19455,신길건영아파트,254,193,447,37.503440464,126.9015875459
19456,신길건영아파트,175,187,362,37.5037354455,126.9016891344
19457,수정교회,419,245,664,37.5011447492,126.8986616843
19458,대림3동주민센터,180,105,285,37.4981672477,126.89831
19483,대영중학교.신길센트럴아이파크,200,176,376,37.5033158892,126.9037578728
19501,당산역11번출구,531,546,1077,37.5333218119,126.9013080631
19502,대림역5번출구,670,489,1159,37.4941881707,126.8949855085
19503,현대2.3차아파트,185,78,263,37.5317408698,126.8962827493
19504,한국환경수도연구원,79,18,97,37.5439176005,126.8895618243
19505,성애병원,43,4,47,37.5117534209,126.9218040841
19506,당산우편물취급소,21,5,26,37.5295966069,126.8987624869
19507,기아자동차서비스센터,66,1,67,37.5415448626,126.8913397384
19508,신일어린이공원,14,3,17,37.5102387979,126.9219968319
19509,대림역7호선,822,40,862,37.4929638313,126.8973315956
19510,효성아파트,24,23,47,37.5309951483,126.8998637918
19511,한신아파트.선유도공원,42,5,47,37.5406104569,126.892357296
19512,돈보스코.홈플러스,30,18,48,37.4966558275,126.913235866
19513,창의나라어린이집,34,45,79,37.5088147597,126.9215458547
19515,우성2차아파트,233,157,390,37.495363567,126.8998625176
19516,당산역.삼성래미안APT,371,102,473,37.5332251433,126.90153447
19518,경남아너스빌,66,23,89,37.4946517549,126.9108450745
19519,골프장,10,18,28,37.509504,126.919979
19520,코스트코,71,67,138,37.5283666153,126.8916609531
19521,대림3동주민센터,94,267,361,37.4983606603,126.8985174011
19522,삼성래미안4차아파트북문,520,13,533,37.5332286177,126.9030109389
19523,선유도역.롯데홈쇼핑,83,9,92,37.537024567,126.893134081
19524,강남성심병원.대림성모병원,91,38,129,37.4913065278,126.9080614234
19525,대신시장.기업은행,55,11,66,37.5118632601,126.9173777932
19526,당중초등학교.노동부남부지청,72,57,129,37.5253866305,126.8906255086
19527,대림3동사거리,95,250,345,37.4995406902,126.898036257
19528,당산중학교.한국소방안전원,31,39,70,37.5318890724,126.9065022141
19529,영등포동.영등포푸르지오아파트,116,49,165,37.511019637,126.9053948102
19530,신대림한솔솔파크아파트.충심교회,84,56,140,37.4884697209,126.8990679328
19532,영은교회,66,64,130,37.5253616898,126.8882070346
19534,강변래미안아파트,36,88,124,37.5300982551,126.9072184064
19535,케이카,40,38,78,37.5342360825,126.8923381705
19536,대림중앙시장,53,48,101,37.4899047632,126.9007034903
19538,양평역,260,103,363,37.5250571864,126.8860806928
19539,대림요양병원,93,128,221,37.5023314067,126.9001497866
19540,한국산업인력공단,76,190,266,37.5287001541,126.907732684
19541,거성파스텔아파트,286,52,338,37.5321168067,126.8924532355
19542,농협.대림2동주민센터,99,55,154,37.4908121312,126.9017291244
19544,삼성아파트.오목교아래,77,61,138,37.523415383,126.8834600409
19546,인구보건복지협회.제일빌딩,186,306,492,37.5260382148,126.9087700692
19547,선유고등학교,141,37,178,37.533133368,126.8945892066
19548,대림포교원,57,101,158,37.4920558755,126.9030879611
19550,벽산아파트,53,52,105,37.5232854003,126.8824379434
19551,성락교회,543,352,895,37.5044937034,126.9029768745
19552,한강성심병원,185,183,368,37.5233299681,126.9105439558
19553,대림1동새마을금고,211,121,332,37.4930894759,126.9042356303
19555,신동아아파트.관악고교,200,102,302,37.5216618502,126.8852430946
19556,도림사거리,117,101,218,37.5063174421,126.901776669
19557,근로복지공단서울남부지사,68,168,236,37.5213296596,126.9119175238
19558,대림1동주민센터,137,77,214,37.4950637693,126.9064554065
19560,e편한세상문래에듀플라츠,216,145,361,37.5203116387,126.8858598746
19561,선의원,29,112,141,37.5125060183,126.9092502422
19563,태양의집.썬프라자,160,78,238,37.4958177593,126.9073026795
19568,영신고등학교,190,151,341,37.4975925264,126.9083813617
19574,신풍역.수녀원,257,194,451,37.4994414051,126.9077008382
19578,근로복지공단서울남부지사,133,129,262,37.521403714,126.9121380476
19579,현대홈타운아파트,99,69,168,37.5234161815,126.8958915081
19581,삼성래미안아파트1단지,40,107,147,37.5052062815,126.9162315361
19582,벽산메가트리움APT,102,71,173,37.5185695277,126.8979141721
19583,약산약국,116,159,275,37.5113138822,126.9142968662
19584,한강성심병원,130,116,246,37.5233986262,126.9107746728
19585,문래역.홈플러스,36,67,103,37.5204548137,126.8952702414
19586,대영초중고,86,65,151,37.5020836656,126.9045860784
19587,삼성래미안아파트2단지,68,64,132,37.50671281,126.914227473
19588,영일시장.록스,128,123,251,37.5183513018,126.9008724859
19590,인구보건복지협회.호텔아벤트리,184,132,316,37.5262167779,126.9089587972
19591,교보생명,22,80,102,37.5206586901,126.8927264952
19594,신길역2번출구,190,32,222,37.518244,126.916014
19595,한국산업인력공단,75,49,124,37.5282975197,126.9081846411
19596,GS홈쇼핑앞,139,208,347,37.5210328929,126.8900548852
19628,래미안에스티움,164,172,336,37.4998586582,126.9137184414
19630,강변래미안아파트,39,69,108,37.5304101377,126.907349271
19631,양평동서통한신아파트,125,129,254,37.52137241,126.8879274737
19645,당산역.지하철2호선,3424,2476,5900,37.5347400035,126.9023377955
19662,당산중학교.한국소방안전원,4,181,185,37.5322315724,126.9066070161
19663,모랫말.도림새마을금고,213,178,391,37.5085202288,126.90021733
19674,삼성래미안동문,4,20,24,37.5311163277,126.9047437209
19676,양평역,277,333,610,37.5253329419,126.8862550017
19679,도림고가.영등포아트자이,120,91,211,37.5104673394,126.8989591367
19684,당산센트럴아이파크아파트,55,25,80,37.5294473708,126.902510571
19685,영은교회,177,95,272,37.5250867538,126.888897178
19687,도림교회,223,116,339,37.5093467611,126.8973227342
19688,선화약국,25,1,26,37.510653566,126.9172405721
19697,당산효성.현대5차아파트,27,31,58,37.530173327,126.9009081058
19698,노동부남부지청,84,57,141,37.524638835,126.8917297019
19700,도림동주민센터,741,115,856,37.5087971934,126.8964095201
19701,DMC두산위브더퍼스트,63,167,230,37.5087029116,126.9174161583
19702,DMC두산위브더퍼스트,238,61,299,37.5169493984,126.896353001
19703,대신시장,314,438,752,37.5121237758,126.9165402359
19705,힐스테이트삼송역,8,24,32,,
19707,현대APT후문,20,85,105,37.524228566,126.8944184537
19708,코오롱아파트,37,276,313,37.5080318381,126.8948323653
19709,대성유니드아파트,74,41,115,37.5011675241,126.9027187793
19710,골프장,20,36,56,37.5088334824,126.9199045396
19713,문래자이후문,20,14,34,37.5168991207,126.8986416285
19729,영등포구청.우리은행,87,197,284,37.5254398537,126.8966953828
19730,골프장,37,23,60,37.5090406202,126.9202843938
19733,문래동주민센터,56,12,68,37.517601684,126.899351122
19740,신일어린이공원,13,75,88,37.5100192088,126.9224212475
19741,금호아파트,65,107,172,37.5187718947,126.8979309029
19742,도림초교사거리,313,487,800,37.5083375721,126.9049106738
19745,도림동주민센터,191,482,673,37.5084902631,126.8961493649
19748,도림교회,73,203,276,37.5092269217,126.8973308164
19749,대림역5번출구,300,182,482,37.4948666991,126.8948001273
19751,건영아파트,234,372,606,37.5057686993,126.9018101899
19752,선유고등학교,64,135,199,37.5332901567,126.8945867229
19753,도림고가.동아에코빌,123,330,453,37.5101175984,126.8988261304
19756,선유초등학교후문,94,145,239,37.5327075965,126.892091436
19757,도림새마을금고,265,377,642,37.5084857554,126.8999436394
19758,e편한세상문래에듀플라츠,152,190,342,37.5204494891,126.8858415635
19760,케이카,11,27,38,37.5343029295,126.8925202511
19761,도림사거리,140,463,603,37.5070907884,126.9009386259
19762,대림요양병원,142,133,275,37.5025321694,126.8999334882
19765,선유도역.롯데홈쇼핑,15,126,141,37.5370485077,126.8934442009
19770,대림3동사거리,224,116,340,37.4993863615,126.8977582395
19773,당산초등학교,80,65,145,37.5386977962,126.8947635611
19774,대영초중고,139,146,285,37.502528,126.904047
19775,노동부남부지청,21,64,85,37.5253724672,126.8909004588
19776,대림동현대3차아파트,356,368,724,37.504466,126.896397
19777,대림3동주민센터,242,114,356,37.4980793659,126.8983424791
19778,한신아파트.선유도공원,3,64,67,37.5406592181,126.8924692571
19780,남성아파트,25,33,58,37.5122034905,126.8910896456
19781,신안인스빌아파트,19,50,69,37.5137354671,126.8885413891
19782,삼환아파트,45,19,64,37.5137855121,126.8904512019
19783,문래공원사거리,20,67,87,37.51398,126.893088
19786,우성2차아파트,17,208,225,37.4955536164,126.8994440527
19794,동양아파트,0,118,118,37.5417610376,126.8902700202
19800,대동초등학교.명지성모병원,23,430,453,37.49420138,126.8987627859
19806,신길5동우체국,143,175,318,37.4980404548,126.9080395961
19809,한솔아파트,12,87,99,37.5438918495,126.8880522051
19811,문래동주민센터,11,48,59,37.5169596562,126.8986940319
19812,태양의집.썬프라자,65,240,305,37.4961223744,126.9073565889
19813,신길동오거리,3,6,9,37.5103913564,126.9159401511
19814,신기목련아파트.더샵파크프레스티지,5,37,42,37.5090172393,126.9158201061
19821,경방타임스퀘어.신세계백화점,2165,3624,5789,37.517327,126.90598
19827,대영고등학교.신길센트럴아이파크,306,113,419,37.5048823685,126.904922203
19833,대림1동주민센터,103,180,283,37.4950914919,126.90618847
19834,대림1동새마을금고,141,170,311,37.4933580173,126.9042511202
19835,대림포교원,54,93,147,37.4924371503,126.9032197838
19836,농협.대림2동주민센터,61,141,202,37.4908109691,126.9014158733
19837,신대림한솔솔파크아파트.충심교회,69,87,156,37.4888933803,126.8992324664
19840,당서초교,6,59,65,37.531111114,126.8995389009
19844,현대3차유원아파트,52,250,302,37.5319345944,126.8973008278
19846,양화대교전망카페,18,168,186,37.53982,126.901182
19847,신풍프라자,28,44,72,37.5017864827,126.9015122861
19848,양화대교전망카페,17,142,159,37.539938,126.900755
19849,문래힐스테이트아파트,496,770,1266,37.5194239626,126.8914974004
19850,문래힐스테이트아파트,243,607,850,37.519647,126.891508
19851,영등포소방서.타임스퀘어,243,101,344,37.518273873,126.9036355463
19852,영등포구청,279,204,483,37.5243137974,126.8952226639
19857,현대2.3차아파트,97,125,222,37.5326083,126.8969389534
19858,신동아아파트.관악고교,387,359,746,37.5223558864,126.8855026473
19862,당산역,662,436,1098,37.5330028905,126.9010480642
19865,삼성래미안아파트,71,57,128,37.5074069381,126.9130481182
19867,골프장,29,57,86,37.5086934741,126.9199176151
19868,삼환아파트,73,67,140,37.5071313862,126.9200285195
19869,병무청,23,36,59,37.5063656176,126.9216230712
19870,대방동성당,53,27,80,37.5051599656,126.9216560023
19871,신길한성아파트,152,311,463,37.5041513635,126.9199106731
19872,신길중앙새마을금고신길4동지점,159,468,627,37.5054257948,126.9126669015
19877,래미안영등포프레비뉴아파트,24,22,46,37.5056353604,126.9069364632
19878,신길힐스테이트클래시안아파트,121,87,208,37.5055906938,126.9114530403
19879,신길파크자이아파트,60,42,102,37.5049340573,126.9135627503
19880,서울해군호텔,42,54,96,37.5042586234,126.9160026751
19882,대방동성당,41,74,115,37.5050446711,126.9217262504
19883,병무청,16,37,53,37.5063629983,126.9217497583
19884,삼환아파트,44,52,96,37.5074906089,126.9198821423
19885,오거리,15,40,55,37.5086678983,126.9215731559
19888,서울해군호텔,39,160,199,37.5045438605,126.9159749818
19892,영등포역1번출구,355,264,619,37.514679,126.907997
19893,영등포역2번출구,1245,769,2014,37.5145839767,126.9078196924
19894,신길GS자이아파트정문,22,16,38,37.5062985565,126.9171066208
19895,신길GS자이아파트후문,49,33,82,37.5061002907,126.9157992808
19896,신길4동주민센터,32,14,46,37.5081805356,126.911555177
19899,신길GS자이아파트정문,16,41,57,37.5061310478,126.91724367
19902,성산대교남단,0,1,1,37.5468335281,126.8890059514
19911,푸른숲아파트,19,44,63,37.5087156723,126.9176242751
19984,영등포푸르지오,360,10,370,37.5117732064,126.9034753573
19985,대우미래사랑,151,18,169,37.5123000589,126.9009464467
19986,영등포아트자이,206,50,256,37.5109906474,126.8988576208
19987,영등포아트자이,35,182,217,37.5114597361,126.8995214906
19988,대우미래사랑,13,248,261,37.5118103168,126.9004176959
19990,영등포푸르지오후문,169,325,494,37.513267,126.904886
19997,여의도지하차도,29,13,42,37.5268770852,126.9188153744
20001,동작상떼빌아파트,1405,1436,2841,37.486449,126.904448
20002,신대방경남아파트,2716,3072,5788,37.4902521491,126.9075951828
20003,신대방현대아파트,2106,1001,3107,37.4952827397,126.9114761949
20004,보라매공원,1524,1243,2767,37.4968990034,126.9162238534
20005,보라매역.동작세무서,1343,1658,3001,37.4981412047,126.9201964462
20006,강남중학교,1716,1054,2770,37.5037895503,126.9218983526
20007,현대아파트,2559,2160,4719,37.513174,126.931437
20008,현대아파트.유한양행,1145,1247,2392,37.5132368488,126.9323737344
20009,노량진수산시장.CTS기독교TV,2118,2926,5044,37.513423,126.938456
20010,노량진수산시장.CTS기독교TV,5177,3039,8216,37.5134800797,126.9388655754
20011,노량진역,2101,1296,3397,37.513733,126.943811
20012,노량진역,1589,1701,3290,37.5138325876,126.9447114504
20013,노들역,1891,1207,3098,37.512825,126.949256
20014,노들역,1244,1721,2965,37.512734203,126.9509621786
20015,갯마을앞,1419,2460,3879,37.4975550541,126.983311749
20016,정금마을.방배경찰서,1466,1063,2529,37.4942338943,126.9826144422
20017,경문고교.배나무골앞,1014,1455,2469,37.4915912163,126.9826229009
20018,총신대입구역.남성사계시장입구앞,3184,2486,5670,37.4882168341,126.9822243706
20019,사당동우체국앞,1677,1222,2899,37.4832273743,126.9819451238
20020,방배노인종합복지관,1007,1769,2776,37.4806790282,126.9818145731
20106,서울지방병무청앞,1555,967,2522,37.506935,126.923275
20107,공군호텔,2568,1719,4287,37.5100106698,126.9245410607
20108,대방역,1286,1618,2904,37.5125881335,126.926363433
20111,KT동작지사,192,211,403,37.5130395413,126.9356600816
20114,노량진역3번출구,1710,7943,9653,37.5134951577,126.9418756112
20115,노량진역2번출구,5024,927,5951,37.5139058884,126.9434701519
20117,사육신공원,93,203,296,37.5133666069,126.9463011308
20119,사육신공원,258,252,510,37.513315,126.947977
20121,노들역,1100,710,1810,37.5128653113,126.9510505061
20122,노들역,48,128,176,37.512565,126.951007
20123,흑석동효사정앞,453,747,1200,37.5115545148,126.9607461983
20124,흑석동효사정앞,715,515,1230,37.5115728985,126.9612375315
20125,흑석역.흑석동빗물펌프장,1223,1575,2798,37.508304935,126.9632135267
20126,흑석역.명수대현대아파트,1037,705,1742,37.5074984059,126.9650447528
20127,흑석역.명수대현대아파트,641,463,1104,37.5075850724,126.9655921789
20128,흑석동명수대현대아파트,27,174,201,37.5073485306,126.96627337
20129,비계,794,283,1077,37.50651,126.967675
20130,비계,436,608,1044,37.5064370015,126.9685844969
20131,흑석동한강현대아파트,160,396,556,37.505867,126.971748
20132,흑석동한강현대아파트,24,110,134,37.505609,126.971971
20133,동작역.국립현충원,828,427,1255,37.502586,126.976865
20134,동작역.국립현충원,695,1185,1880,37.503188597,126.9766525988
20141,사당1동상점가,1987,2312,4299,37.476831893,126.9778214942
20142,엔지니어링회관,1439,2238,3677,37.4760492272,126.972845088
20143,서울공업고등학교,707,1145,1852,37.4997751387,126.9223387688
20144,서울공업고등학교,949,438,1387,37.4999614514,126.921570953
20145,대림초등학교,1120,1652,2772,37.4996077724,126.9264810316
20146,대림초등학교,1250,638,1888,37.4998553553,126.926127913
20147,성대시장,2295,2197,4492,37.4999961167,126.9309085729
20148,성대시장,3129,2253,5382,37.5002832355,126.9317049239
20149,상도초등학교입구,1827,1280,3107,37.5033523537,126.9367065599
20150,상도초등학교입구,1045,1381,2426,37.502959881,126.9357682657
20151,장승배기역,1079,1262,2341,37.5046761432,126.9385221188
20152,동작문화복지센터.동작보건소,826,1298,2124,37.5049377205,126.9407908692
20153,동작문화복지센터.동작보건소,1196,649,1845,37.5053297317,126.9417292605
20154,상도노빌리티아파트,862,679,1541,37.5047947107,126.9459415102
20155,상도노빌리티아파트,868,1031,1899,37.5043269596,126.9468675132
20156,상도터널.노들역3번출구,433,470,903,37.5120566862,126.9541121628
20157,상도터널.노들역4번출구,832,1060,1892,37.5120063166,126.9536978866
20158,상도터널상도동,1369,2588,3957,37.5045988081,126.9495037012
20159,상도터널상도동,1483,976,2459,37.5038586483,126.9495190801
20160,상도역,1450,1646,3096,37.5016271328,126.9486225374
20161,상도역,1180,979,2159,37.5012490566,126.9495197061
20162,상도동중앙하이츠빌.상도전통시장,1281,1597,2878,37.4988131751,126.9511850423
20163,상도동중앙하이츠빌.상도전통시장,1858,795,2653,37.4986899661,126.9517743709
20164,숭실대입구역,656,537,1193,37.4969260383,126.9528039826
20165,숭실대입구역,3643,2107,5750,37.4961666089,126.9533491547
20166,숭실대입구역,3733,5294,9027,37.4964614208,126.9537334982
20167,봉현초등학교,817,2043,2860,37.4916784048,126.9562148589
20168,봉천고개.관악현대아파트,1819,1598,3417,37.4917326146,126.9565953054
20169,숭실대중문앞,343,848,1191,37.49515,126.957055
20170,숭실대중문앞,455,302,757,37.4953183557,126.9572808442
20171,숭실대별관앞,465,681,1146,37.4946390733,126.9602929082
20172,숭실대별관앞,385,739,1124,37.4949847404,126.959906757
20173,사당5치안센터,362,134,496,37.4890277761,126.9656493194
20174,총신대,213,407,620,37.4887422791,126.9661798164
20175,총신대,544,196,740,37.4878598183,126.9664743548
20176,사당중학교,494,506,1000,37.4863556315,126.9682728248
20177,사당중학교,293,439,732,37.4866369532,126.9681789127
20178,남성역,916,356,1272,37.4849291221,126.9707465249
20179,남성역,417,677,1094,37.4845875371,126.9710943103
20180,남성역골목시장,1036,724,1760,37.4838042897,126.9730147719
20181,남성역골목시장,363,245,608,37.4836762564,126.9727824251
20182,남성초등학교,201,369,570,37.4840745961,126.9785857201
20183,남성초등학교,187,177,364,37.4842992298,126.9784299949
20184,이수역9번출구,311,385,696,37.4844435384,126.9798968352
20185,이수역10번출구,687,385,1072,37.4848328619,126.9801874958
20186,신대방삼거리,2016,1564,3580,37.4977748671,126.9278411369
20187,신대방삼거리,1891,2326,4217,37.4983305124,126.9282547192
20188,보라매병원입구,966,1508,2474,37.494757,126.927191
20190,동작구청.노량진초등학교앞,1763,795,2558,37.5105502162,126.9400540684
20191,동작구청.노량진초등학교앞,609,2437,3046,37.510453,126.940337
20192,장성교회,1225,974,2199,37.5082110072,126.9399682084
20193,청화병원,2302,1765,4067,37.5072450833,126.9400798321
20194,중앙대학교,2608,1496,4104,37.5081669276,126.9613219646
20195,중앙대학교,1012,880,1892,37.508509243,126.9615071968
20196,중앙대학교,783,402,1185,37.5083452201,126.9614382814
20197,7호선장승배기역.상도2치안센터,1941,879,2820,37.5041718438,126.9391355764
20198,7호선장승배기역.상도2치안센터,631,1513,2144,37.503934,126.939496
20199,상도2동아이파크.포스코더샵아파트,217,1151,1368,37.5014793109,126.9408309246
20200,상도2동아이파크.포스코더샵아파트,646,319,965,37.5015136806,126.9411384938
20201,신상도초등학교,309,703,1012,37.4993163958,126.9435348692
20202,중앙대후문,100,495,595,37.5048082949,126.9536355983
20203,중앙대후문,374,185,559,37.5045504993,126.9534310317
20204,중앙대정문,104,550,654,37.506809885,126.9582944153
20205,중앙대중문,170,109,279,37.5066428313,126.9572653015
20206,중앙대정문,1506,303,1809,37.5072313914,126.9591141596
20207,신대방역,136,330,466,37.4873791461,126.9123158741
20208,신대방역,80,78,158,37.4874171465,126.9117427128
20209,동작상떼빌아파트,122,79,201,37.488253739,126.9071028224
20210,신대방경남아파트,114,168,282,37.4884286507,126.9072269982
20213,사당롯데캐슬골든포레.사당해그린,232,511,743,37.492298,126.963578
20217,서울특별시.보라매병원,948,499,1447,37.4927554341,126.92448039760001
20219,신상도초등학교,667,148,815,37.4993739229,126.9436736712
20220,상도4동약수맨션,2254,633,2887,37.4979423686,126.9435500396
20221,경향렉스빌.롯데캐슬비엔,1006,645,1651,37.4959295429,126.9429139957
20222,경향렉스빌.롯데캐슬비엔,474,597,1071,37.4959853248,126.9427352625
20228,상도4동약수맨션,696,676,1372,37.4979590401,126.9433569275
20233,래미안상도3차중문,84,367,451,37.4998750017,126.9538679944
20235,금양빌딩,101,109,210,37.4995065114,126.953501942
20240,동작구청정문,1834,581,2415,37.5123768448,126.9400621552
20241,상도SH빌아파트상도팰리스후문,94,160,254,37.5026546449,126.9539708958
20242,상도SH빌아파트상도팰리스후문,149,179,328,37.5031415122,126.9542926452
20243,상도3차삼성래미안후문,178,192,370,37.5010547638,126.9538226802
20244,상도3차삼성래미안후문,295,199,494,37.5009407383,126.9535689972
20245,상도1동주민센터.상도3차래미안,124,199,323,37.498406161,126.9533571784
20246,상도1동주민센터.상도3차래미안,106,257,363,37.4982214146,126.9532555151
20247,노들역앞,124,285,409,37.513521,126.952211
20248,대방역1번출구앞,1216,296,1512,37.5130975089,126.9274742701
20249,대방역.여의교앞,10,129,139,37.514757,126.92733
20250,노들역4번출구앞,41,33,74,37.5124572784,126.9533594381
20251,동작실버센터입구.용양봉저정,76,202,278,37.5131208822,126.956610643
20252,사당동대아신협앞,385,174,559,37.4833774271,126.9762903614
20253,사당역9번출구앞,2298,913,3211,37.47739263,126.9813958895
20254,사당롯데캐슬골든포레.사당해그린,643,238,881,37.4924365852,126.9630718231
20266,중산공원.중산파출소,47,10,57,,
20267,중산공원.중산파출소,5,48,53,,
20295,부대앞.고양실업고교,13,1,14,,
20349,백석8블록,75,76,151,,
20434,대화역,37,111,148,,
20470,대화역,78,31,109,,
20494,사당솔밭도서관,74,59,133,37.4840171336,126.9670560347
20495,효주파크빌,54,90,144,37.50279,126.926694
20496,남성초등학교입구,166,144,310,37.4837563501,126.9769232473
20497,벽산아파트,4,4,8,37.497733194,126.9218266232
20498,정금마을,17,6,23,37.4937773108,126.9813618064
20499,이수힐스테이트.이수푸르지오,58,80,138,37.4940582217,126.979752481
20500,사당역10번출구,157,27,184,37.4786874149,126.9815810731
20501,현대2차아파트후문,101,159,260,37.5107012975,126.9320347501
20502,극동상가,492,732,1224,37.491687286,126.9740958456
20503,삼성래미안.롯데캐슬,1691,894,2585,37.4896270276,126.9711491739
20504,자이아파트정문앞,694,13,707,37.4891368419,126.9627803005
20505,달마사.흑석어린이집,139,122,261,37.500332,126.960569
20507,사자암,359,462,821,37.4937689308,126.9363189798
20508,노들역.노량진교회,9,4,13,37.5124284915,126.9544767096
20509,대림현대아파트.사당3동주민센터,505,623,1128,37.4861568443,126.9724840951
20510,행복유치원,589,605,1194,37.4961628916,126.9408148527
20511,이수역,2713,1005,3718,37.4850014413,126.9806261973
20512,보라매공원,12,55,67,37.4946211032,126.9185784927
20513,신대방삼거리역,915,249,1164,37.4999673048,126.9281819736
20515,현대2차아파트후문,31,119,150,37.511078,126.932111
20516,극동아파트110동,60,1,61,37.4903636891,126.9746719153
20517,극동아파트110동,63,5,68,37.4908474626,126.9741210149
20518,대림아파트후문.래미안로이파크,314,12,326,37.4886519328,126.9721846371
20519,자이아파트상가앞,217,1,218,37.4886828031,126.963155966
20520,삼성래미안아파트,14,0,14,37.497718,126.95927
20521,상도4동성문교회.상도어울마당,658,528,1186,37.499156,126.940108
20522,당곡중.고등학교,37,8,45,37.493045235,126.9353994727
20524,대림프라자,126,8,134,37.4839260244,126.9738757634
20526,삼성래미안.롯데캐슬솔레,12,459,471,37.4898234441,126.9712716065
20527,보라매공원입구,12,59,71,37.4960060597,126.9180850756
20528,강현중학교,53,122,175,37.5020677375,126.9278709369
20529,구중앙슈퍼앞,54,12,66,37.4946119215,126.935503992
20530,유앤미아파트,604,9,613,37.5007063168,126.9604578422
20531,우리교회,10,16,26,37.4977604263,126.9317185301
20532,극동아파트112동,78,2,80,37.4885987803,126.9763424207
20533,삼일공원,136,14,150,37.4868510064,126.9738555209
20534,사당종합체육관,207,389,596,37.4925240349,126.9696348409
20535,숭실대후문,10,7,17,37.4950952786,126.9610345638
20536,더크는킨더어린이집,111,3,114,37.4996265622,126.9406672593
20537,갑을명가아파트,146,49,195,37.4936940869,126.9345740345
20539,사당시장,596,194,790,37.4830900688,126.9751266748
20540,롯데캐슬비엔,91,10,101,37.4968433468,126.9430908619
20541,삼거리,525,151,676,37.4855998149,126.9683026096
20542,대방어린이도서관,117,117,234,37.5029619498,126.9254812795
20543,성심슈퍼,55,23,78,37.4951429733,126.9344155696
20544,흑석자이.흑석한강센트레빌2차,1326,11,1337,37.50209,126.960429
20545,롯데캐슬샤인,7,217,224,37.4909223103,126.9714963842
20546,남성초등학교.사당청소년센터,66,64,130,37.4860104896,126.974840744
20547,신남성초교후문,64,13,77,37.4890283675,126.9645998909
20549,현대아이파크,178,80,258,37.5008885718,126.9416027519
20550,영은교회,103,34,137,37.4943957803,126.9340950389
20552,이수시너스.이수역7번출구,141,619,760,37.4839100097,126.9818671422
20554,갑을명가,58,125,183,37.4825754825,126.9667508946
20555,성남중고,103,113,216,37.5045784206,126.9253134035
20556,청운종합복지관,96,20,116,37.4955668475,126.933440322
20557,은로초등학교,441,18,459,37.5032630745,126.9609201815
20558,롯데캐슬샤인,99,5,104,37.491095683,126.9712023203
20559,동작삼일수영장,89,7,96,37.4873936762,126.9747984396
20560,삼거리우편물취급소,14,230,244,37.4841645764,126.9770554226
20561,사당.인정아파트,73,29,102,37.4899710309,126.9649635841
20564,선재유통,280,100,380,37.4946581742,126.9328021506
20565,중앙대병원,1277,325,1602,37.507689887,126.9607327929
20567,밤골터널.상도역롯데캐슬파크엘,168,370,538,37.5018651497,126.9460153285
20568,동작고교,250,223,473,37.4818218649,126.9664294375
20569,대림아파트후문.성남중.고교,181,162,343,37.505674745,126.9248146272
20570,구동사무소,0,2,2,37.4961096391,126.9324298965
20571,중대부속초등학교,215,189,404,37.5053724551,126.9610502124
20573,국사봉중학교,38,17,55,37.4931806671,126.9437280828
20574,장승배기역4번출구,331,106,437,37.5044810859,126.9377214725
20575,빙수골공영주차장,181,12,193,37.4952795673,126.932158087
20577,상도역1번출구,484,805,1289,37.5027474813,126.9472102115
20578,이수역,75,353,428,37.4845151722,126.9799858332
20579,동작상떼빌앞,71,48,119,37.4877057013,126.9080420892
20580,대방동주민센터,38,86,124,37.5081772155,126.9261670483
20581,빙수골마을공원,41,6,47,37.4965518983,126.9321116975
20582,중앙대병원후문.흑석시장,719,1376,2095,37.506984,126.961766
20584,방범초소,25,24,49,37.4941682832,126.9437420438
20585,주택가,14,50,64,37.505774,126.936377
20586,백경세탁소,163,13,176,37.4966448723,126.930834755
20587,중앙대중문,496,191,687,37.5067385205,126.95728804
20588,중대후문입구,1404,851,2255,37.5043455055,126.9501363221
20589,신대방1동주민센터,11,40,51,37.487040971,126.9095785564
20590,주공아파트.남도학숙,290,234,524,37.5087023253,126.9289889124
20591,상도3동주민센터,20,164,184,37.4991727218,126.9312735142
20593,삼성래미안.동작청소년센터,161,127,288,37.5056368127,126.9345388097
20594,하손초장교회,11,116,127,37.4978176529,126.9300612128
20595,중앙대후문,1075,685,1760,37.5050512225,126.9535419345
20596,이화약국,379,443,822,37.5049512146,126.950537456
20598,숭의여중.고교,89,42,131,37.5079144369,126.9299522538
20599,현대한의원,498,143,641,37.5001592705,126.9325619694
20600,사당문화복지관,70,201,271,37.4853423386,126.9695707031
20673,사회복지관앞,76,51,127,37.506067189,126.9330780951
20674,7호선신대방삼거리역2번출구.국민은행,187,749,936,37.4989658209,126.928418089
20675,대림프라자,36,502,538,37.4838072598,126.9743794236
20676,상도은빛어르신복지관.터널경로당,186,268,454,37.5065716922,126.9512512508
20681,동광교회,176,83,259,37.5015543584,126.9344857415
20682,남성역.남성역골목시장,92,693,785,37.4841806903,126.9722197399
20684,대방목욕탕,38,109,147,37.5071048664,126.9323905778
20686,건영아파트,445,353,798,37.5078829377,126.9515987872
20694,갯마을,117,150,267,37.4962336425,126.9825370124
20695,현대아파트,59,211,270,37.512052615,126.9320467559
20697,경문고등학교,133,58,191,37.4901811137,126.9824479616
20698,삼거리우편물취급소,219,81,300,37.4842177829,126.9772691231
20699,밤골.상도역롯데캐슬파크엘,34,116,150,37.5021520208,126.9455943644
20700,남부교회,342,261,603,37.5089709879,126.9322870912
20701,정금마을,68,18,86,37.4943392794,126.9825628967
20702,동작고등학교,157,234,391,37.4815722629,126.9664442487
20703,KT동작지사,41,37,78,37.5121801399,126.9344730609
20704,7호선장승배기역2번출구,107,295,402,37.5039320639,126.9389672411
20705,총신대역,1287,306,1593,37.487347383,126.9820415707
20706,남성초등학교.사당청소년센터,16,135,151,37.4861375742,126.9749763981
20717,고양실업고등학교,1,27,28,,
20718,고양실업고등학교,21,1,22,,
20725,동원베네스트,22,47,69,37.5034539195,126.9451749249
20726,신동아정문,312,133,445,37.5101499659,126.9512523172
20727,사당솔밭도서관,37,83,120,37.4834269187,126.9670879553
20728,해태타워앞,58,58,116,37.4910939039,126.9246607439
20729,경성의원.새마을금고앞,17,120,137,37.5126188873,126.935954556
20730,상도2동주민센터,232,224,456,37.5050526535,126.9417827452
20731,상도은빛어르신복지관,122,265,387,37.5063885967,126.9505398317
20732,삼일공원,10,297,307,37.4869726909,126.9740160547
20740,부강탕,33,85,118,37.5043671116,126.9459908973
20741,대방역1번출구,36,412,448,37.5130699136,126.9274282269
20745,극동아파트앞,23,160,183,37.5110727392,126.951363704
20746,이수역,560,84,644,37.4865725229,126.9820869839
20747,삼거리,32,293,325,37.4855349747,126.9684496405
20748,전문건설회관.보라매병원,43,46,89,37.4923592428,126.9249580304
20751,대림아파트후문.래미안로이파크,6,244,250,37.4884618946,126.9725906795
20756,상도브라운스톤,22,43,65,37.505286117,126.9438049608
20787,노들역5번출구,33,680,713,37.5122904513,126.9521592788
20789,상도노빌리티,788,557,1345,37.5051800181,126.9466710231
20790,상도역.하나은행,527,877,1404,37.5038198475,126.9473327434
20791,봉천고개관악현대아파트,132,432,564,37.4921183007,126.9566324017
20792,동작삼일수영장,19,204,223,37.4871765076,126.9747872044
20794,동작고교.사당5동주민센터,44,136,180,37.4852068927,126.9675296545
20799,건영아파트,899,524,1423,37.5069702375,126.9480050422
20801,우성201동.극동112동,2,201,203,37.4881461014,126.9759330153
20802,삼호APT.오네뜨아파트,10,274,284,37.4865452277,126.9656301015
20803,동작구건강관리청,80,21,101,37.5054913714,126.9415426118
20804,남부교회,493,326,819,37.5091952385,126.9320719695
20805,도시가스.두산아파트,95,126,221,37.505053155,126.9447020905
20808,7호선신대방삼거리역4번출구,54,65,119,37.4998232995,126.9267443461
20809,우성아파트,783,401,1184,37.508454,126.947083
20810,숭실대입구역2번출구,1880,300,2180,37.4961965212,126.9535564495
20811,시장입구,56,70,126,37.4894721027,126.977157838
20812,신남성초교입구,5,177,182,37.4879028591,126.9645031705
20813,새소망교회,46,28,74,37.5063972057,126.9420033988
20814,대방목욕탕,71,53,124,37.507519,126.932239
20815,본동초등학교,0,1,1,37.5107266973,126.9535550176
20818,코오롱하늘채아파트,69,57,126,37.4991700746,126.9240090902
20819,강남교회.오거리,782,562,1344,37.5102778468,126.9449289949
20820,봉천고개현대아파트,234,225,459,37.4919019936,126.9562362162
20822,신동아아파트,17,175,192,37.4900072452,126.9765786726
20823,LG아파트상가,2,687,689,37.4886009282,126.963560848
20824,신동아아파트701동앞,95,57,152,37.5074809233,126.9432253093
20825,사회복지관앞,67,100,167,37.505902297,126.9330952089
20828,동작우체국,15,16,31,37.4978102285,126.9238815363
20829,테니스장.우성아파트304동,19,149,168,37.4906189658,126.9759361455
20830,자이아파트정문앞,11,383,394,37.4893053683,126.9628435447
20832,신동아관리사무소.영어마루도서관,141,55,196,37.5083076038,126.9440017764
20833,삼성래미안.동작청소년센터,72,183,255,37.5055356102,126.9348170675
20834,대방역2번출구앞,1257,718,1975,37.5127789562,126.9275880089
20836,경성의원.새마을금고앞,105,34,139,37.5127937149,126.9359804244
20837,노량진역,645,3036,3681,37.5137237868,126.941453612
20839,신동아상가,129,28,157,37.5079978025,126.9463253599
20840,주택가,8,49,57,37.5055040763,126.9364798085
20842,예스플러스,48,68,116,37.5039638554,126.9224942472
20843,KT동작전화국,23,50,73,37.5123694199,126.9345611292
20844,9호선노량진역.동작구청,1115,137,1252,37.5130148375,126.940088794
20845,숭실대후문,1,14,15,37.4950484626,126.9611601225
20846,건영아파트,0,10,10,37.5073665272,126.9476598101
20847,장승배기역4번출구,86,300,386,37.5044197304,126.9375688275
20848,테니스장앞,2,26,28,37.4981116101,126.9593670537
20850,숭의여중고교.공군항공안전단,29,98,127,37.5073826349,126.9296959851
20851,7호선장승배기역5번출구,199,254,453,37.5050962917,126.938975342
20854,현명약국,83,197,280,37.504496659,126.936506677
20855,더크는킨더어린이집,2,231,233,37.4997752435,126.9406660106
20856,본동시장,1239,131,1370,37.5122399144,126.9519737943
20857,성원아파트,20,45,65,37.508821774,126.925418897
20858,상도4동성문교회.상도어울마당,106,40,146,37.4991450337,126.9399946942
20859,극동아파트,46,197,243,37.511110522,126.9512098387
20861,대방동주민센터,87,168,255,37.5083866972,126.9261640144
20862,쌍용아파트,19,171,190,37.5015039566,126.93298603
20864,삼성래미안아파트,184,468,652,37.5103454356,126.9510847768
20865,대림아파트후문.성남중.고교,124,307,431,37.5058658913,126.9249920186
20866,성대시장,1459,437,1896,37.5000808511,126.9322988293
20867,노량진역,3209,154,3363,37.5135038929,126.9432478962
20868,강현중학교.동작청소년센터,33,187,220,37.5030004211,126.9345122587
20869,한신아파트,142,605,747,37.5087397453,126.95125889
20870,대방교회,72,130,202,37.5039714206,126.9230394173
20871,계령약국,168,204,372,37.4989754823,126.9333826454
20872,건영아파트후문,250,685,935,37.5078063047,126.9515026905
20873,대방동주택가.홈타운아파트,45,76,121,37.5039451009,126.9241422416
20874,강남교회.오거리,422,562,984,37.5102462423,126.9447876219
20875,상도은빛어르신복지관.터널경로당,108,162,270,37.5065409316,126.950953788
20876,강남중학교앞,134,117,251,37.502975,126.924153
20877,사거리,48,523,571,37.496036362,126.9367943174
20878,우성아파트,355,696,1051,37.508537,126.946766
20880,범한택시,62,191,253,37.500061271,126.9240183662
20881,제일성민교회,138,672,810,37.4954606322,126.9371965528
20882,신동아리버파크,203,980,1183,37.5066765081,126.9477107912
20883,안일약국,24,275,299,37.4977616565,126.934555783
20884,상도역2번출구,1260,437,1697,37.5029069167,126.9470766344
20885,달마사,1,1,2,37.4995357728,126.9606900215
20886,동작하이슈퍼,94,316,410,37.4950179926,126.9365045428
20887,상도노빌리티,493,467,960,37.5053838502,126.9466416761
20888,밤골.상도역롯데캐슬파크엘,51,259,310,37.501955207500004,126.9459219623
20890,상도역5번출구,2262,486,2748,37.5035799614,126.9489458159
20891,약수맨션.약수당약국,282,1496,1778,37.4982526063,126.9435185194
20892,현진빌라.고마트,3,94,97,37.4972109542,126.9430023671
20893,중앙대후문,584,2083,2667,37.5050129803,126.9539815854
20894,건영아파트,31,124,155,37.5074478171,126.9476344677
20896,중앙대중문,139,630,769,37.5064893501,126.9573559193
20897,신동아상가,24,239,263,37.50813015,126.9460741526
20898,중앙대정문,139,839,978,37.5067437707,126.958223341
20899,신동아관리사무소.영어마루도서관,46,218,264,37.5084979923,126.9445445828
20901,중앙대병원,2394,1443,3837,37.5075405164,126.9613764833
20902,신동아아파트701동앞,35,112,147,37.5075024276,126.9429719204
20903,보라매어린이집.문창중학교,11,13,24,37.4977191463,126.9231862171
20904,중앙대병원후문.흑석시장,317,128,445,37.5064627639,126.9612695829
20906,새소망교회,32,86,118,37.5062095609,126.9415658051
20907,동작우체국,101,53,154,37.4977295307,126.9245070504
20908,중앙대부속초등학교.롯데캐슬에듀포레,76,353,429,37.5049212013,126.9607856633
20909,신대방삼거리역.성대시장,204,62,266,37.4982254734,126.9279311823
20910,은로초등학교,47,781,828,37.5032573835,126.9607814881
20911,신대방1동경남아파트,37,124,161,37.489931954,126.9075610052
20912,흑석한강센트레빌2차.흑석자이,38,1174,1212,37.5022199637,126.9603298144
20913,부강탕,122,47,169,37.5045473263,126.9459783256
20914,유앤미아파트,11,657,668,37.5009247014,126.9601325904
20915,동원베네스트,26,42,68,37.5032059252,126.9447645304
20916,보라매병원.전문건설회관,49,60,109,37.492988,126.923833
20917,동양아파트.달마사,284,606,890,37.4995634362,126.9598585367
20918,밤골.상도역롯데캐슬파크엘,85,49,134,37.5019654526,126.9455074093
20919,아카데미타워,229,83,312,37.4912126935,126.9244163541
20921,신대방역,556,305,861,37.4874991805,126.9130146621
20922,빌라삼거리.영도교회.약수터,122,157,279,37.4953540701,126.9436054409
20923,신대방1동주민센터,18,61,79,37.4872123087,126.9097457115
20924,방범초소,64,91,155,37.4944263836,126.9435828924
20925,신대방현대아파트,38,64,102,37.4951584458,126.9116914272
20926,국사봉중학교,7,108,115,37.4933842425,126.9435729947
20927,신대방우성아파트앞,39,215,254,37.4933430025,126.9103818246
20928,교수아파트,10,39,49,37.496296383,126.913422836
20929,보라매공원입구,61,9,70,37.4960713855,126.9177800417
20930,보라매공원,4,12,16,37.4947672843,126.9182419159
20931,삼일초등학교앞,52,4,56,37.4881057301,126.9756632895
20932,상도초등학교,66,55,121,37.5028527874,126.9360217143
20933,신동아상가,162,123,285,37.5087596306,126.9514070573
20934,현대아파트,681,218,899,37.5123455625,126.9319173232
20935,서달산약수터,0,8,8,37.4998489184,126.9620217296
20938,장성교회,142,181,323,37.50743942,126.9399010423
20939,숭의여중고교.공군항공안전단,95,251,346,37.5079992556,126.9301467298
20940,대방동주공아파트,594,710,1304,37.5090527881,126.9288799898
20941,노량진신한은행,625,260,885,37.5121553851,126.9441708438
20942,노량진한국법학교육원,329,1038,1367,37.512353703,126.9443313266
20943,7호선신대방삼거리역2번출구.국민은행,455,24,479,37.4988284774,126.9285171719
20944,하손초장교회,12,19,31,37.4977131036,126.9300251189
20945,백경세탁소,11,56,67,37.4965907359,126.9307149228
20946,빙수골공영주차장,12,126,138,37.4952993071,126.9320110465
20947,선재유통,27,162,189,37.4945545203,126.9327547444
20948,영은교회,1,63,64,37.494379503,126.9339921386
20949,갑을명가아파트,14,59,73,37.4936012213,126.9344802493
20950,당곡중.고등학교,22,56,78,37.4929175466,126.9355630875
20951,사자암,11,30,41,37.4937167132,126.936404974
20952,동작하이슈퍼,6,34,40,37.4949180583,126.9367296655
20953,제일성민교회,28,42,70,37.495337429,126.9374010926
20954,보문사,27,56,83,37.4961202394,126.938645622
20955,동아아파트,6,48,54,37.4964310253,126.9401630759
20956,행복유치원,7,28,35,37.4957521106,126.9412493715
20957,동아아파트,0,6,6,37.496605859,126.940130707
20958,보문사,17,23,40,37.4962395013,126.9385591149
20959,사당1동주민센터입구,329,795,1124,37.484087397,126.9787425623
20960,노들역5번출구앞,63,63,126,37.5125403512,126.9525311749
20965,동작대교남단,0,1,1,37.5061409451,126.9739596436
20966,청호아파트,25,62,87,37.5007517363,126.9637881997
20967,푸르지오후문,11,11,22,37.5015927889,126.9643336036
20968,푸르지오상가,4,30,34,37.5034197881,126.9650367495
20969,흑석한강푸르지오,13,19,32,37.5042938575,126.9653558384
20970,흑석동주민센터,17,30,47,37.5058669213,126.9664605238
20971,대방중학교,48,77,125,37.4954921867,126.9144839499
20972,동작구건강관리청,0,34,34,37.5054948614,126.9413118652
20973,수도여고.남부수도사업소,209,110,319,37.4935547507,126.9152513015
20974,동작구민체육센터.기상청,21,42,63,37.4942400994,126.9172420906
20975,동작구민체육센터.기상청,64,52,116,37.4944139686,126.9171796976
20976,수도여고.남부수도사업소,99,113,212,37.4938774194,126.9148815723
20977,대방중학교,44,27,71,37.495531285,126.9145761544
20978,정금마을,22,86,108,37.4939326631,126.9811660051
20979,경동아파트,2,16,18,37.5094841427,126.9537175431
20980,동양중학교,0,26,26,37.5091142107,126.9548036777
20981,극락정사,3,15,18,37.5080479239,126.9518056786
20983,흑석역,24,38,62,37.5092011475,126.9623026038
20984,중앙대병원,12,39,51,37.5074356533,126.9603641787
20985,상도역1번출구,16,65,81,37.5025855614,126.9478369293
20986,봉천고개관악현대아파트,0,168,168,37.4913451421,126.956601184
20988,상도3동주민센터,26,61,87,37.4995035166,126.9298933823
20989,양녕청년주택,13,199,212,37.4966794533,126.936166566
20990,두산위브아파트,626,65,691,37.484877791,126.9708754546
20992,보라매역.동작세무서,47,25,72,37.4992308508,126.9201906523
20995,보라매역.동작세무서,53,113,166,37.4979925451,126.920229403
20997,신남성초교입구,68,3,71,37.4877091329,126.9645405795
20998,삼호.오네뜨아파트,53,1,54,37.4866037163,126.9653451099
20999,사당5동주민센터,18,3,21,37.4850737353,126.9674932038
21001,구로디지털단지역,6503,12972,19475,37.4839345974,126.9024471276
21002,구로디지털단지역,10814,10728,21542,37.4839770128,126.9024669147
21027,사당자동차학원,28,372,400,37.4713005916,126.9832945728
21028,화훼단지,1702,1670,3372,37.4748233089,126.9817223705
21072,린파밀리에,408,488,896,,
21082,린파밀리에,563,700,1263,,
21101,서울미술고.인헌중고,1571,2052,3623,37.4764663412,126.9655544411
21102,낙성대입구,1983,1127,3110,37.4779096847,126.9618756708
21103,행운동주민센터,1992,1339,3331,37.4798444396,126.9568690307
21104,서울대입구역5번출구,2467,1221,3688,37.4816281486,126.951014176
21105,KT관악지점,1007,1015,2022,37.4820390166,126.9471913134
21106,봉천역.관악초등학교,2325,2288,4613,37.4824403435,126.9431518504
21107,KT&G관악지점,857,1105,1962,37.4844754738,126.9373129096
21108,신림사거리.신림역,2264,561,2825,37.4841492836,126.9278542438
21109,남부초등학교,1340,2435,3775,37.4834020208,126.922044754
21110,호림박물관,885,1440,2325,37.4827231582,126.9183765847
21111,난곡입구,865,1709,2574,37.4822370031,126.915722964
21112,관악구보훈회관.신림푸르지오,2033,2021,4054,37.481361666,126.9112396639
21113,천주교성령봉사회관.등불교회,644,1123,1767,37.4807554146,126.9079578883
21114,KT구로지사,1726,1308,3034,37.4802646679,126.9049986272
21115,난곡입구,2271,1463,3734,37.4819399662,126.9161388018
21116,남서울중학교.성보중고등학교,2683,2167,4850,37.4828195546,126.9210108639
21117,신림사거리.신림역,2739,8655,11394,37.483817804,126.9280626243
21118,KT&G관악지점,870,1060,1930,37.484533,126.936125
21119,봉천역.관악초등학교,2074,1981,4055,37.4820551447,126.9431153969
21120,KT관악지점,1477,1423,2900,37.4814828857,126.9484610699
21121,봉천사거리,2189,2614,4803,37.4803684653,126.9545837877
21122,낙성대동,812,1249,2061,37.4792747849,126.9573911237
21123,낙성대입구,1048,1574,2622,37.4778444821,126.9608874889
21124,인헌중고.서울미술고,1826,1423,3249,37.4756534429,126.9666239506
21125,예술인마을.사당초등학교,1679,1452,3131,37.4759368363,126.9738846758
21126,남서울농협남현동지점,1759,1462,3221,37.476370961,126.9773008972
21127,서울대학교,441,443,884,37.4667414611,126.9479522861
21128,서울대학교,1862,768,2630,37.4668539107,126.9488427043
21129,서울여상.서울문영여중고앞,725,610,1335,37.4731604796,126.9533001437
21130,관악구청,1435,3686,5121,37.4779819797,126.9524977507
21131,봉천사거리.봉천중앙시장,5523,2616,8139,37.4828873794,126.9542258337
21132,봉원중학교.행운동우성아파트,2751,1522,4273,37.4849010896,126.9559128703
21133,관악푸르지오아파트,1767,1393,3160,37.4877034434,126.9581660971
21136,성현동동아아파트,1746,1637,3383,37.488401645,126.957732596
21137,봉원중학교.행운동우성아파트,2468,3406,5874,37.4848580279,126.955335791
21138,봉천사거리.봉천중앙시장,481,1055,1536,37.4831545464,126.9538387042
21139,관악구청,4845,2464,7309,37.4793471271,126.9521875661
21140,관악경찰서.관악소방서,500,990,1490,37.475253,126.952572
21141,서울여상.서울문영여중고앞,187,930,1117,37.473002,126.952845
21142,신림중.삼성고.관악아트홀.도서관,454,1026,1480,37.470352,126.944412
21143,서울산업정보학교.삼성교,1162,2230,3392,37.4710142867,126.941124806
21144,신성초등학교,1858,1043,2901,37.4710779706,126.9374233711
21145,서울대벤처타운역1번출구,1668,977,2645,37.473206969,126.933686278
21146,쑥고개입구,3359,736,4095,37.4761917072,126.9374950813
21147,서원역1번출구.신관중학교,1328,1465,2793,37.4786498144,126.9323856945
21148,신림사거리,916,2277,3193,37.4819257882,126.9300715056
21149,신림동별빛거리입구,3426,2120,5546,37.4858478867,126.9296319572
21150,당곡역.보라매공원.보라매병원,1918,1497,3415,37.4904418111,126.9276205633
21151,당곡역2번출구.롯데백화점관악점,1454,1850,3304,37.4900092446,126.9274852912
21152,신림동별빛거리입구,1719,2087,3806,37.4864151799,126.929060426
21153,신림사거리,4758,1067,5825,37.482767098,126.9296377666
21154,서원역,1078,1410,2488,37.4779185578,126.9327230039
21155,서림동주민센터.신화단지,926,2383,3309,37.4755291616,126.9363417324
21156,서울대벤처타운역.삼성동시장,1282,1477,2759,37.4727127526,126.9329597367
21157,대학동고시촌입구,2059,1813,3872,37.470538,126.938381
21158,서울산업정보학교.삼성교,1795,621,2416,37.470573816,126.9420276971
21159,관악산입구.관악아트홀.중앙도서관,891,372,1263,37.4677578665,126.9468707158
21160,당곡역.당곡사거리.롯데백화점,81,148,229,37.4910041432,126.9270746638
21161,사당역4번출구,12,985,997,37.4755408508,126.9813590372
21163,남태령역,88,585,673,37.46557,126.987784
21164,낙성대입구,252,244,496,37.4782931407,126.9579938257
21165,삼성동주민센터,1221,1197,2418,37.4700056074,126.9330211856
21166,미림고개,158,797,955,37.4681128919,126.9319828921
21167,미림여고.미림여자정보과학고,351,1136,1487,37.465641,126.931333
21168,신우초등학교,151,345,496,37.462487,126.93169
21169,삼성산성지,14,297,311,37.458825,126.929865
21170,산장아파트,165,592,757,37.459955,126.927725
21171,삼성산주공아파트,405,811,1216,37.461345,126.925109
21172,산복터널.관악산휴먼시아2단지,72,650,722,37.458697,126.922015
21173,산복터널.관악산휴먼시아2단지,462,95,557,37.4590812203,126.9225758449
21174,삼성산주공아파트,497,298,795,37.4611062672,126.9250910137
21175,산장아파트,561,65,626,37.4597961436,126.9275003475
21176,삼성산성지,39,74,113,37.4586127523,126.9298863649
21177,신우초등학교,530,231,761,37.4624107186,126.9319560545
21178,미림여고.미림여자정보과학고,1333,284,1617,37.4651129483,126.9316212418
21179,미림고개.고시촌입구,921,438,1359,37.4677922169,126.9320992763
21180,서울대벤처타운역,1274,1046,2320,37.4706929498,126.9335914518
21181,쑥고개,334,654,988,37.478535389,126.9403975075
21182,e편한세상서울대입구아파트,276,306,582,37.4795321814,126.9428290096
21183,영락고교.영락의료과학고,524,205,729,37.4792126295,126.9456223075
21184,생모리츠타운,351,259,610,37.479050171,126.947758707
21185,관악구청,160,583,743,37.4787271125,126.9507973533
21186,생모리츠타운,300,382,682,37.4792461009,126.9476681239
21187,영락고교.영락의료과학고,269,467,736,37.4793964639,126.9456413962
21188,e편한세상서울대입구아파트,277,490,767,37.4797304539,126.9429334382
21189,쑥고개,242,714,956,37.4786269166,126.94012124
21190,은천교,566,927,1493,37.4862741791,126.9358192432
21191,봉일시장,806,462,1268,37.4861847891,126.9387053001
21192,은천초등학교,594,400,994,37.486084336,126.9424344854
21193,두산.벽산아파트.서울관광고등학교,831,768,1599,37.4867862492,126.945256088
21194,현대시장앞,920,378,1298,37.486735,126.947932
21195,관악동부센트레빌아파트앞,467,386,853,37.4862395065,126.951997229
21196,중앙동성당앞,201,553,754,37.4858038301,126.9546624721
21197,중앙동성당앞,672,433,1105,37.4859234164,126.9551938213
21198,관악동부센트레빌아파트앞,240,797,1037,37.4864744102,126.95130163
21200,벽산.두산아파트.서울관광고등학교,710,894,1604,37.4869646301,126.9451745389
21201,은천초등학교,376,576,952,37.4863200172,126.942448318
21202,봉일시장,589,684,1273,37.4862623399,126.9389872733
21203,은천교,412,322,734,37.4864887267,126.9355505303
21204,신림청소년독서실.신림체육센터,654,544,1198,37.480922,126.914797
21205,난곡우체국사거리,1068,602,1670,37.4771890136,126.915601446
21206,신일교회앞.도깨비시장,1340,339,1679,37.4754531432,126.9167650134
21207,세이브마트앞,1991,379,2370,37.47385703,126.918037
21208,남강중고등학교입구,1884,382,2266,37.4722574159,126.9195218742
21209,우림시장.난곡보건분소,2868,396,3264,37.4705471261,126.9200007204
21210,난우중학교입구,1019,118,1137,37.4666919669,126.92054078
21211,신림복지관앞,805,71,876,37.4652824875,126.9196773902
21212,신림복지관앞,114,811,925,37.465357,126.919495
21213,난우중학교입구,152,825,977,37.467392,126.920348
21214,우림시장.난곡보건분소,463,2029,2492,37.470667112,126.9197417798
21215,남강중고등학교입구,410,1688,2098,37.4725557947,126.9191422392
21216,세이브마트앞,595,1910,2505,37.4739579362,126.9174336686
21217,신일교회앞.도깨비시장,217,1491,1708,37.475399,126.916574
21218,난곡우체국사거리,506,1317,1823,37.4769808612,126.9154305767
21219,신림청소년독서실.신림체육센터,763,1196,1959,37.480315301,126.9146624536
21220,KT구로지사,52,46,98,37.4812745555,126.90539986
21221,골목시장앞,41,41,82,37.4815094057,126.9053800168
21222,조원동주민센터,113,94,207,37.4834358832,126.9074141948
21223,조원동주민센터,35,39,74,37.483184422,126.9070563124
21224,신대방역,171,501,672,37.4865794735,126.9130032118
21225,신대방역,3242,4078,7320,37.4866700184,126.9126962022
21226,보라매공원입구,341,312,653,37.4891229048,126.9174897386
21227,보라매공원입구,493,387,880,37.489435269,126.9178010867
21228,보라매갑을아파트,264,676,940,37.4896486343,126.9220386039
21229,롯데관악점,1040,750,1790,37.4897262326,126.9251647188
21230,롯데관악점,1546,1482,3028,37.4901297758,126.9257070748
21231,당곡역,269,227,496,37.4892995107,126.9270622168
21232,당곡중학교,584,441,1025,37.488084986,126.9305421031
21233,당곡중학교,304,424,728,37.487948574,126.9319168564
21236,봉현초등학교,393,947,1340,37.4907157496,126.9554672808
21237,동아아파트105동앞,568,403,971,37.49052765,126.955414395
21239,관악드림타운115동,176,1188,1364,37.490522127,126.9527938777
21240,관악드림타운115동,850,388,1238,37.490144527,126.9530108571
21241,관악드림타운북문,195,602,797,37.491600782,126.951276815
21242,관악드림타운북문,763,385,1148,37.4915440732,126.9510801201
21243,구암중학교,387,521,908,37.4924641868,126.9483401995
21244,구암중학교,595,606,1201,37.4922862923,126.9484647078
21245,벽산아파트.적십자남부봉사관,6,100,106,37.492953,126.946532
21246,벽산아파트.적십자남부봉사관,118,13,131,37.4930533731,126.9461601934
21247,벽산블루밍벽산아파트303동앞,355,4,359,37.4919397992,126.944368715
21248,구로디지털단지역,1236,747,1983,37.4838240234,126.9026875907
21251,현대시장,404,745,1149,37.4868811315,126.947836543
21252,서울대입구역,2835,7058,9893,37.4801109505,126.9527297656
21253,신봉초등학교입구,374,390,764,37.4841900104,126.9468251624
21254,구암초등학교,768,268,1036,37.4891880904,126.9461216984
21255,은천동벽산블루밍아파트105동,347,580,927,37.4893681933,126.9458637343
21256,은천동두산아파트3단지,408,397,805,37.484358827,126.9465536842
21257,봉일시장,147,257,404,37.4850728694,126.9372434322
21258,봉천역,1017,268,1285,37.4832362109,126.942119674
21259,현대시장,743,580,1323,37.4876789537,126.9465909455
21260,현대시장,662,540,1202,37.4874402599,126.9465203946
21261,관악우체국.에이치플러스양지병원,1488,1395,2883,37.4848480554,126.933156959
21262,관악우체국.에이치플러스양지병원,1518,1170,2688,37.4844524654,126.9331482652
21263,보라매삼성아파트.모자원고개,1118,1326,2444,37.4945144044,126.9273975559
21264,조원힐스테이트뉴포레아파트,162,272,434,37.4835747238,126.9061605387
21265,관악산휴먼시아.신림푸르지오2차,534,922,1456,37.460381143,126.919522697
21266,관악산휴먼시아아파트1단지입구,462,284,746,37.4609276261,126.9219633037
21267,관악산휴먼시아아파트1단지입구,489,730,1219,37.4609929949,126.9216300665
21268,난향동주민센터,951,473,1424,37.461001,126.919167
21269,서울대정문,66,122,188,37.4657347092,126.9483888926
21270,법대.사회대입구,27,365,392,37.4627982772,126.9489902258
21271,자연대.행정관입구,136,922,1058,37.4602745925,126.9488328413
21272,농생대,189,1017,1206,37.4571629782,126.9491669695
21273,공대입구,85,404,489,37.4549310083,126.9498437849
21274,신소재연구소,52,173,225,37.4534963067,126.9502261839
21275,제2공학관,1460,957,2417,37.4487952024,126.9520772668
21276,유회진학술정보관.제1공학관,614,114,728,37.451283,126.952595
21277,유전공학연구소.반도체공동연구소,383,69,452,37.4540103657,126.9539020813
21278,교수회관입구,148,63,211,37.4560708573,126.9553487986
21279,관악사삼거리,994,316,1310,37.4607880575,126.9567262582
21280,국제대학원,81,40,121,37.4641772176,126.9553134553
21281,수의대입구.보건대학원앞,363,140,503,37.4661235124,126.9546291437
21282,경영대.행정대학원,690,170,860,37.466135,126.952053
21283,경영대.행정대학원,261,675,936,37.4658058493,126.9509996213
21284,수의대입구.보건대학원앞,134,505,639,37.4658377051,126.954645472
21285,국제대학원,18,229,247,37.4637089159,126.9549273195
21286,관악사삼거리,168,997,1165,37.460528,126.95666
21288,공동기기원,64,414,478,37.4551189492,126.9544665701
21289,유전공학연구소.반도체공동연구소,94,250,344,37.4537476916,126.9535516289
21290,에너지자원연구소,235,296,531,37.4535952522,126.9522141729
21292,공대입구,705,73,778,37.4553640041,126.949896448
21293,농생대,1043,105,1148,37.4571128404,126.9493877458
21294,자연대.행정관입구,894,51,945,37.4599898135,126.9489559518
21297,문화관입구,112,9,121,37.4614868493,126.9494503629
21298,법대.사회대입구,169,106,275,37.463260537,126.9490724143
21299,서울대정문,140,349,489,37.4653754725,126.9486357857
21300,우방아파트,96,0,96,37.489233,126.919247
21301,은천성결교회,116,1,117,37.4883272437,126.9214262581
21302,남부초교후문,235,3,238,37.4867197461,126.9226406129
21303,봉림교,39,37,76,37.4847770708,126.9245166934
21304,봉림교,6,73,79,37.4849717829,126.9246318378
21305,남부초교후문,80,221,301,37.4864491785,126.9222366697
21309,청담고시원,2,65,67,37.4716612193,126.9399508583
21310,우리슈퍼,21,253,274,37.4722845735,126.9393706575
21311,명호고시원,7,82,89,37.4733194431,126.938860909
21312,동작마트,41,69,110,37.4742815521,126.938356196
21313,제일성도교회,160,3,163,37.4748334585,126.9404392562
21314,삼양슈퍼,161,1,162,37.4751039806,126.9420665874
21315,금성마트용천사,96,218,314,37.4750292676,126.942807788
21316,삼양슈퍼,2,254,256,37.4749343135,126.9421136493
21317,제일성도교회,3,112,115,37.4746577628,126.9404789678
21318,동작마트,89,11,100,37.4749391205,126.9380334582
21319,고시촌입구,493,580,1073,37.4705489387,126.9376643153
21320,대학동치안센터,169,539,708,37.4690418042,126.9376455022
21321,대학동노인정,2,503,505,37.46735,126.93757
21322,금호타운아파트,15,1419,1434,37.4657396064,126.9376595486
21327,금호타운아파트,1189,5,1194,37.4657104128,126.9378291297
21328,대학동노인정,266,20,286,37.4671591135,126.9376868773
21329,대학동치안센터,423,76,499,37.4689379452,126.9377735833
21330,서울대입구역,5702,2273,7975,37.4807005941,126.9524440164
21332,청림동현대아파트,337,29,366,37.491334,126.957561
21333,청림동현대아파트,996,971,1967,37.491948,126.959384
21335,보성운수기종점,466,257,723,37.4641267565,126.9190213265
21337,난곡공영차고지,143,331,474,37.463938,126.918963
21338,한남운수대학동차고지,568,1,569,37.4703789731,126.9398175867
21339,한남운수대학동차고지,4,913,917,37.4701939082,126.9396934801
21340,제2공학관,106,466,572,37.4480848677,126.9521425546
21341,건설환경종합연구소앞,41,123,164,37.4472002497,126.9496963827
21342,봉일시장,54,22,76,37.4855325313,126.9372877479
21343,보라매공영주차장,11,242,253,37.4887044852,126.9342323482
21344,당곡중고교,4,176,180,37.4911229426,126.9340425015
21345,연희빌라,2,94,96,37.4925826472,126.9338080186
21346,재넘이고개,234,213,447,37.4928281646,126.9353672862
21347,연희빌라,120,0,120,37.4925289803,126.9337389141
21348,당곡중고교,130,4,134,37.4911375856,126.9339322377
21349,보라매공영주차장,191,6,197,37.4887260569,126.9341339458
21350,신림사거리.신림역,8723,3395,12118,37.4841991011,126.9282759755
21351,신사동주민센터.신사시장,182,163,345,37.4855925982,126.9178057215
21352,건영유치원,2,63,65,37.4850495896,126.9145919609
21353,신대방역,144,1111,1255,37.4864484117,126.9136841115
21354,난곡사거리,145,137,282,37.483037,126.914462
21355,난곡사거리,124,277,401,37.4827675299,126.9142384082
21356,신대방역,2572,226,2798,37.4863653637,126.9134840538
21357,신사시장.평화교회,126,139,265,37.4844679227,126.9138803062
21358,신사시장.선한이웃교회,122,600,722,37.4845275146,126.9140379945
21359,신림청소년독서실.신림체육센터,189,310,499,37.4804433853,126.9148713746
21360,신사동진양빌딩앞,642,206,848,37.4876940621,126.9146115645
21361,호림박물관,1440,997,2437,37.4823672056,126.918618871
21363,보성운수차고지맞은편,133,0,133,37.4646708176,126.9192632133
21364,조원아파트,136,225,361,37.484088,126.90782
21365,성원홈아파트,3,203,206,37.4902310566,126.9344142103
21366,성원홈아파트,96,8,104,37.4902039601,126.9343000164
21367,신림빗물펌프장,96,63,159,37.4847740495,126.9076301967
21368,봉천사거리.위버폴리스,1659,2543,4202,37.4827934095,126.9535723145
21369,서원동승리교앞,542,295,837,37.4815862804,126.9299073023
21370,서울난향초등학교.난향동주민센터,358,545,903,37.4627367836,126.9188888522
21371,은천길입구,83,71,154,37.4866475818,126.9336112524
21373,서울대학교치과병원.동물병원,1039,387,1426,37.4692744185,126.9520815656
21374,서울대학교치과병원.동물병원,168,865,1033,37.470034,126.951937
21375,신림2교,79,174,253,37.477526,126.93678
21376,서울대학교,138,220,358,37.4676609636,126.9496319032
21377,신림역2번출구,713,3554,4267,37.4833220413,126.929897162
21378,벽산블루밍아파트종점,4,338,342,37.492105,126.944636
21379,청림동현대아파트입구,3,463,466,37.4910748741,126.957413445
21501,아카시아마을.민방위교육장,97,5,102,37.4720765376,126.9110629666
21502,난향동공영차고지,289,218,507,37.4634784081,126.9189072689
21503,청림동푸르지오아파트121동앞,1086,222,1308,37.4855867055,126.9606640782
21504,보명사.법화사,282,148,430,37.4760734942,126.9248318555
21505,현대아파트후문,710,1352,2062,37.4752551368,126.9304689235
21506,GS편의점.소망유통,545,71,616,37.4693187251,126.9686576958
21507,국사봉,448,6,454,37.491065,126.941744
21508,봉천역,2101,82,2183,37.4835902775,126.9409009883
21509,뉴서울아파트,365,0,365,37.4714170168,126.9111256421
21511,푸르지오122동,421,7,428,37.4860981959,126.9596641783
21512,승산밝은빛교회.구무림비디오,317,0,317,37.4757279844,126.9242273045
21513,코사마트,318,17,335,37.4762191632,126.9302023262
21514,인수당약국,578,3,581,37.4701674287,126.9681361509
21515,만물슈퍼,9,0,9,37.4907882284,126.9418503621
21517,신협,214,107,321,37.4831950485,126.9465737839
21518,쌍용아파트후문,206,0,206,37.4726771928,126.9117541837
21520,관악로입구,157,52,209,37.4864265271,126.9580220655
21521,한마음슈퍼,397,3,400,37.4753175115,126.9234984545
21522,미성빌라,195,22,217,37.4770770731,126.9302987658
21523,우리현대마트,595,6,601,37.4710782857,126.9675399492
21524,우리슈퍼,201,3,204,37.4903837611,126.9421119066
21526,두산아파트입구,150,174,324,37.4847729966,126.9468248253
21527,벽산아파트501동.적십자센터,43,23,66,37.4929053524,126.9465804386
21528,신라놀이터,63,5,68,37.4732481844,126.9125494627
21531,충남슈퍼,364,1,365,37.4749187609,126.9227888212
21532,해성세탁소,141,9,150,37.4776960894,126.9303876606
21533,동인약국.인헌중고입구,472,10,482,37.4719720293,126.9669821806
21534,수정슈퍼,368,3,371,37.4898025437,126.9421010465
21536,현대시장,1045,425,1470,37.4870735721,126.9469475848
21537,벽산아파트,191,54,245,37.4922931588,126.9438938598
21538,두영아파트,483,7,490,37.474298874,126.9137749689
21539,삼성산주공정문,252,64,316,37.480443,126.914873
21540,서울대입구역2호선,2087,1361,3448,37.4824664116,126.9538359816
21541,제일교회입구,323,4,327,37.4745263191,126.9220871034
21542,GS편의점,84,25,109,37.4784379432,126.93063897
21543,오리사랑,179,87,266,37.4737417629,126.9668389441
21544,서울관광고등학교,391,5,396,37.4890752374,126.9418663911
21545,구암초등학교정문,164,121,285,37.4881663803,126.9464345431
21546,현대홈타운아파트,7,186,193,37.47934,126.963367
21547,미성중학교,80,21,101,37.4755708036,126.9131844409
21548,삼성산주공307동앞,377,39,416,37.4617159167,126.9273354547
21549,관악프라자,81,21,102,37.4835760192,126.954733128
21550,남강중고등학교입구,196,8,204,37.4741455935,126.9213944256
21551,동산교회,74,22,96,37.4790015356,126.929792687
21552,인헌연세약국,53,227,280,37.4750663629,126.9667445158
21553,신선마트,179,6,185,37.4886722866,126.9415478054
21555,방앗간,63,207,270,37.4899711367,126.9460928644
21556,낙성대역,15,1272,1287,37.4777900122,126.9624207194
21557,라이프아파트,712,75,787,37.4771733447,126.9136959114
21558,2단지종합상가,708,103,811,37.4635774095,126.9263183097
21560,애동유치원,169,68,237,37.4742691695,126.9202354038
21561,서강약국,1167,340,1507,37.4794709098,126.9281244578
21562,원당시장입구,145,439,584,37.47542833,126.9657720013
21563,경천교회,283,72,355,37.4880274638,126.9404796696
21564,대학원생활관,443,56,499,37.4623361202,126.9573923129
21565,성현동주민센터,231,152,383,37.489861,126.947285
21566,사랑의병원,938,452,1390,37.4796244089,126.9564304426
21567,신림고등학교,1049,369,1418,37.4776805895,126.9160901041
21568,203동앞,221,88,309,37.4644446975,126.9264976658
21569,관악로입구,21,230,251,37.4862759617,126.9577948573
21570,종합시장.세이브마트,311,86,397,37.4741762919,126.918818829
21571,동부아파트,398,490,888,37.4813012413,126.9284313945
21572,파리바게트.낙성대지하철,207,1695,1902,37.4761438371,126.964376791
21573,국회단지입구,272,240,512,37.4865995241,126.9393194579
21574,학부생활관,479,65,544,37.4637506192,126.9580724931
21575,구암어린이집앞,149,371,520,37.4909558362,126.9476358057
21576,낙성대역,1058,31,1089,37.4778756928,126.9626592502
21578,난곡터널,698,47,745,37.4779795626,126.9183861861
21579,광신고등학교.주공1단지,737,96,833,37.4660286495,126.927107173
21580,우성아파트103동,1,473,474,37.4860917446,126.9592457839
21581,난우초등학교,167,99,266,37.475947114,126.917730357
21582,삼모타워앞.건강보험관악지사,333,687,1020,37.4824006069,126.9284597454
21583,인헌초등학교,279,191,470,37.4771072368,126.9617606091
21584,은천교앞,439,68,507,37.4864003668,126.9358819578
21585,BK국제관,443,83,526,37.4654239013,126.9578693178
21586,관악드림타운2단지,396,867,1263,37.4917149515,126.9470590155
21587,현대홈타운아파트,66,89,155,37.4791296644,126.9634796509
21588,갑을아파트,16,19,35,37.4897535048,126.9220551526
21589,신원동치안센터,427,145,572,37.4790908751,126.9270325662
21590,유완약국.성림교회,228,41,269,37.4668169248,126.9300505356
21591,행운동우성아파트109동앞,6,1433,1439,37.4852903366,126.9612178671
21592,신림고등학교,236,216,452,37.4778966436,126.9160754865
21593,낙성대입구,68,110,178,37.4778081338,126.9599795717
21594,신림성모성당앞,9,61,70,37.4870744065,126.9326664612
21595,가족생활동,224,25,249,37.4669767456,126.9577737723
21597,롯데백화점,56,65,121,37.4904278745,126.9244827354
21598,삼성전자,21,31,52,37.4676943096,126.931084151
21599,신림청소년독서실.신림체육센터,281,231,512,37.4804996928,126.9148759246
21600,봉천7동시장입구,79,121,200,37.4787543427,126.9575345056
21601,관악우체국,106,348,454,37.4851431932,126.9341383461
21602,신림고등학교,73,810,883,37.4779810811,126.9168167167
21604,신림사거리.신원시장,752,2772,3524,37.483709205,126.9273005902
21649,삼성동시장,98,244,342,37.4692039821,126.931631082
21650,난곡사거리,137,389,526,37.4823011931,126.9144634448
21651,신림역,2498,1868,4366,37.4854883196,126.9296506944
21663,인헌아파트,162,129,291,37.468020748,126.9612871638
21675,서울대벤처타운역.삼성동시장입구,189,721,910,37.4718550422,126.9332126245
21677,동부아파트,379,471,850,37.4813200328,126.9282142759
21678,낙성대역,2355,113,2468,37.4763210574,126.9648557613
21686,당곡역.당곡사거리,314,147,461,37.4887310522,126.9287658216
21689,서울융합과학교육원,314,40,354,37.4687224889,126.9579991818
21700,은천교입구,95,45,140,37.4868362979,126.9342753266
21701,은천교입구,23,39,62,37.4869017998,126.9341378486
21722,삼성아파트,19,41,60,37.4945772872,126.9273819286
21732,조원초등학교,112,195,307,37.4835391709,126.9082699572
21733,서강약국,407,758,1165,37.4794735167,126.9279661565
21734,인헌연세약국,190,104,294,37.4748483171,126.9668226263
21738,낙성대공원.다시가는캠퍼스,130,54,184,37.4722000954,126.958771496
21742,신도브래뉴.구펭귄아파트,53,55,108,37.4842112876,126.9110454762
21743,동산교회,48,219,267,37.478779025,126.9298980497
21744,오리사랑,299,203,502,37.4736845489,126.9666847747
21745,봉일시장,535,300,835,37.4861888116,126.9386238431
21752,낙성대현대아파트,66,58,124,37.474872947,126.9591501194
21753,성지빌딩,23,86,109,37.4786119699,126.9308321576
21756,펭귄시장,10,19,29,37.4835748049,126.9123577828
21760,동인약국.인헌중고입구,28,544,572,37.4719152228,126.966851057
21761,국회단지입구,640,332,972,37.486535598,126.9394212827
21765,인헌초등학교,37,219,256,37.4765877555,126.959159362
21766,난곡사거리,133,109,242,37.4825153663,126.9140640456
21768,우리현대마트,8,573,581,37.4711205873,126.967356777
21770,경천교회,26,416,442,37.4879473031,126.9405543681
21771,낙성대입구,16,616,632,37.4775168997,126.9594607468
21772,신림청소년독서실.신림체육센터,300,96,396,37.4810130771,126.914599382
21773,서림동주민센터,69,169,238,37.4748531074,126.9349782707
21774,인수당약국,12,849,861,37.4704430749,126.9677946019
21775,산성교회,10,551,561,37.4885912136,126.9416010182
21778,신원동치안센터,28,171,199,37.4792256381,126.9262096749
21782,현대아파트109동,208,300,508,37.4748734803,126.9333136025
21783,개미유통,16,406,422,37.4699868514,126.9668428641
21784,서울관광고등학교,14,594,608,37.4890410488,126.9419749791
21785,낙성대역,3848,3066,6914,37.4770791769,126.9619751956
21792,관악세무서,53,422,475,37.4791096883,126.9245139173
21793,난우초등학교,95,217,312,37.4764738791,126.9171836708
21794,현대아파트106동,325,364,689,37.4750977377,126.9325313553
21795,세진아파트,9,327,336,37.46963157,126.965980406
21796,수정슈퍼,7,401,408,37.489563775,126.9421498576
21800,낙성대입구,301,63,364,37.4775942987,126.9591814277
21803,난곡터널,4,525,529,37.4783629038,126.9192914361
21809,난곡종점,1057,425,1482,37.4641111686,126.9192841509
21810,종합시장.세이브마트,804,409,1213,37.4742473112,126.9185745369
21812,봉천역,53,38,91,37.4835908978,126.94142738
21817,은천아파트,13,427,440,37.469304232,126.9651699485
21818,우리슈퍼,7,347,354,37.4901513787,126.9423212961
21819,인헌초등학교,120,86,206,37.4765250104,126.9589641387
21820,서울대벤처타운역.삼성동시장입구,866,295,1161,37.4716882063,126.9329810024
21821,애동유치원,31,213,244,37.4741556134,126.9202106507
21823,인헌아파트,111,139,250,37.4682591544,126.9616844863
21841,신림2동차고지,998,5,1003,37.470982,126.938321
21842,신림2동차고지,3,636,639,37.4709277562,126.9387687412
21843,만물슈퍼,83,699,782,37.4910691188,126.9418590704
21844,낙성대현대아파트,54,115,169,37.4744250546,126.9590657284
21851,봉천역,712,671,1383,37.4833341181,126.9417119782
21852,관악드림타운2단지,746,284,1030,37.491838,126.946872
21853,라이프아파트,113,663,776,37.4771669403,126.9135636303
21854,삼성동시장,300,177,477,37.4691600126,126.9314562928
21855,남강중고등학교입구,13,419,432,37.4740843566,126.9214521515
21856,은천아파트,220,10,230,37.4691834753,126.9651417407
21858,낙성대공원.다시가는캠퍼스,41,124,165,37.472483,126.958598
21859,구암어린이집앞,264,121,385,37.4910852873,126.9475270007
21860,미성중학교,5,112,117,37.4756040638,126.9130747297
21861,삼성전자,3,75,78,37.467907393,126.9310872264
21862,제일교회입구,7,510,517,37.4744767955,126.9221436863
21863,세진아파트,144,6,150,37.469516228,126.9659793277
21864,서울융합과학교육원,2,69,71,37.4695643624,126.9579844634
21865,성현동주민센터,152,159,311,37.4900204503,126.9479869626
21866,두영아파트,34,465,499,37.4743494227,126.9136488581
21867,유완약국.성림교회,75,247,322,37.4669079232,126.9300278405
21868,충남슈퍼,4,572,576,37.4748593293,126.922852198
21869,개미유통,77,26,103,37.4698796222,126.966851956
21870,호암교수회관,229,619,848,37.4684563846,126.9583384812
21871,현대시장,255,639,894,37.4872239236,126.9466523339
21872,신라놀이터,36,103,139,37.4733130222,126.9124928566
21873,광신고등학교.주공1단지,260,797,1057,37.4655416947,126.9268060717
21874,한마음슈퍼,5,574,579,37.4752553681,126.9235493967
21875,소망유통,71,367,438,37.4694700428,126.9684009967
21877,두산아파트,52,89,141,37.4847359856,126.9466789803
21878,쌍용아파트후문,2,193,195,37.4727366024,126.9116693186
21879,201동.동신교회,46,321,367,37.4642155732,126.9258566348
21880,승산밝은빛교회.구무림비디오,0,335,335,37.4756424004,126.9242601797
21881,군인아파트,124,35,159,37.4689672354,126.9686942163
21882,교수아파트,38,62,100,37.4682578356,126.957812806
21883,신협,12,220,232,37.4832139179,126.9464550405
21884,뉴서울아파트,4,237,241,37.4715124546,126.9110760714
21885,3단지종합상가,97,631,728,37.4632446739,126.9266500465
21886,보명사.법화사,177,142,319,37.4759816008,126.9248624752
21887,가족생활동,58,148,206,37.4663611632,126.9576895289
21889,봉천역6번출구,2,827,829,37.4832131411,126.9435328569
21890,아카시아마을.민방위교육장,22,160,182,37.4720991366,126.9111579098
21891,삼성산주공307동앞,42,357,399,37.4618249334,126.9273070883
21892,서울대후문.연구공원,126,336,462,37.4651042841,126.9577778409
21893,봉천역4번출구,148,371,519,37.4835860833,126.9415256749
21894,삼성산주공아파트정문,26,354,380,37.4612183906,126.9257024646
21895,학부생활관,66,457,523,37.4631418278,126.957717428
21897,대학원생활관,48,508,556,37.461972752,126.9567820806
21899,기숙사삼거리,52,466,518,37.4604637077,126.9567660056
21904,제2파워플랜트,0,10,10,37.4491961746,126.9495358519
21905,건설환경종합연구소,9,13,22,37.4471691607,126.9497986982
21907,보라매노인복지회관,16,77,93,37.492677921,126.9258907075
21908,신한은행앞.롯데백화점,75,36,111,37.49052084,126.9243299957
21910,벽산아파트,72,233,305,37.4923224192,126.9437182326
21911,적십자센터,1,75,76,37.4930089788,126.9463609225
21912,봉림교,898,1793,2691,37.4836879715,126.9269360965
21913,서원치안센터.건강보험관악지사,551,247,798,37.4819928275,126.9291589334
21915,노천강당,720,805,1525,37.4587949022,126.9553279623
21916,신림역4번출구,6914,5231,12145,37.4839130162,126.9290485663
21919,서원역2번출구.서원동성당앞,22,69,91,37.4778363867,126.9344657489
21920,신림복지관앞,131,0,131,37.4653036588,126.9197650564
22001,말죽거리공원사거리,664,953,1617,37.47859,127.038482
22002,말죽거리공원사거리,1952,1379,3331,37.477657,127.038748
22003,양재역.서초문화예술회관,3382,1768,5150,37.48261,127.035902
22004,양재역.서초문화예술회관,2410,3585,5995,37.481927,127.036827
22005,뱅뱅사거리,1870,2566,4436,37.487667,127.032432
22006,뱅뱅사거리,2586,1881,4467,37.486653,127.033097
22007,래미안아파트.파이낸셜뉴스,2509,3723,6232,37.491895,127.030405
22008,래미안아파트.파이낸셜뉴스,5010,3209,8219,37.491087,127.030987
22009,신분당선강남역,5088,5497,10585,37.4958485587,127.0285365859
22010,신분당선강남역,5869,4501,10370,37.494993,127.029112
22011,지하철2호선강남역,6669,7119,13788,37.501795842,127.0257426414
22012,지하철2호선강남역,9812,5906,15718,37.500785,127.02637
22013,논현역,4732,5568,10300,37.5072264964,127.0230319441
22014,논현역,5101,4020,9121,37.506367,127.023728
22015,신사역.푸른저축은행,2794,5348,8142,37.5141125248,127.0200569534
22016,신사역,3085,2489,5574,37.512972,127.020607
22017,반포역,1233,2114,3347,37.5084114275,127.0118927078
22018,반포역,1770,1383,3153,37.50799929,127.0111518264
22019,고속터미널,9488,7898,17386,37.506290048,127.0051290446
22020,고속터미널,9264,9220,18484,37.5058463491,127.0039245159
22021,신반포역.세화여중고,2461,1868,4329,37.5034181272,126.9957193627
22022,신반포역.세화여중고,2074,2264,4338,37.5030509257,126.9946930536
22023,구반포역.세화고등학교,1307,860,2167,37.5019451598,126.9900264523
22024,구반포역.세화고등학교,1403,2456,3859,37.5017350708,126.9890696352
22025,아리랑TV.국립국악원,168,254,422,37.4788364163,127.0090806179
22026,남태령역,1265,392,1657,37.4656951829,126.9880882012
22027,이수역,2046,2443,4489,37.4823316953,126.9820742447
22028,사당역,3061,2411,5472,37.47423546,126.982118191
22029,총신대입구역.남성사계시장입구앞,3374,3441,6815,37.4875478991,126.9823185463
22031,경문고등학교,1302,1216,2518,37.4904372318,126.9827417832
22033,정금마을,1325,1284,2609,37.4933031442,126.9827186219
22035,염곡마을.서초50플러스센터,488,266,754,37.4611251895,127.0508102806
22036,염곡마을.서초50플러스센터,165,502,667,37.4615627473,127.0494739769
22037,탑성마을.서초포레스타입구,791,196,987,37.4577585114,127.0586887384
22038,탑성마을.서초포레스타입구,185,952,1137,37.4575715332,127.0587253256
22039,안골마을.서울언남초등학교,839,368,1207,37.4557491207,127.0633098065
22040,안골마을.서울언남초등학교,393,499,892,37.4557109244,127.0631289377
22041,샘마을.서울특별시어린이병원,268,224,492,37.4571774154,127.070909122
22042,샘마을.서울특별시어린이병원,213,212,425,37.4568017217,127.0701062932
22043,영동1교교차로,149,351,500,37.472148,127.038769
22044,영동1교교차로,258,458,716,37.472854,127.038548
22045,매헌시민의숲,719,1492,2211,37.469286,127.039534
22046,매헌시민의숲,1318,598,1916,37.470364,127.03875
22068,서초포레스타5단지정문,5,1,6,37.4517781902,127.0583817453
22095,서초종합체육관,97,130,227,37.4585103498,127.0421755314
22096,서울추모공원,0,1,1,37.4541558204,127.0426979933
22097,양재동화물터미널,8,53,61,37.460125761,127.036776987
22098,양재동화물터미널,21,4,25,37.460200853,127.0370766521
22099,서울추모공원,33,5,38,37.4542683928,127.04288117
22100,한국소비자원,32,45,77,37.4660903047,127.0438335124
22101,교대역13번출구,516,1002,1518,37.4917820873,127.0141904192
22102,서울교대사거리,291,153,444,37.4873287224,127.0150603111
22103,교대역2번출구,1551,1477,3028,37.4940242125,127.01538179
22104,서초동유원아파트,915,810,1725,37.495456936,127.020216043
22105,창신교회앞.서리풀노리학교,782,654,1436,37.4904680158,127.0212301612
22106,창신교회.서리풀노리학교,441,301,742,37.4902998844,127.0212807141
22107,서울교대정문앞,546,695,1241,37.4889343385,127.016209575
22108,서울교대정문앞,208,95,303,37.488798,127.016373
22110,서울시인재개발원입구,390,303,693,37.4831074135,127.0222227596
22111,서울시인재개발원.한우리문화센터,189,170,359,37.482652493,127.0217449318
22112,서일초등학교,1290,883,2173,37.4865068533,127.0213146638
22113,서일초등학교,642,1183,1825,37.486141046,127.0210850063
22114,롯데칠성,610,971,1581,37.4966572734,127.0240035889
22115,롯데칠성,210,325,535,37.495077386,127.0252199753
22116,서초포레스타2단지앞,327,426,753,37.455488,127.063037
22117,래미안에스티지에스,352,315,667,37.4925355869,127.0264688183
22118,래미안에스티지,170,298,468,37.4931191063,127.0259403788
22119,서초청소년도서관,736,709,1445,37.4926733807,127.0285677747
22120,서초청소년도서관,1335,700,2035,37.4926228702,127.028880248
22121,서초동신동아아파트,297,257,554,37.4917496945,127.0253914808
22122,서초2동주민센터서이초등학교,178,474,652,37.4915942391,127.0255384282
22123,래미안리더스원아파트,478,378,856,37.490217554,127.0275566247
22124,추모공원입구,0,33,33,37.4583208005,127.0389123105
22125,서초문화예술정보학교후문,1377,782,2159,37.489023218,127.0293961714
22126,서초문화예술정보학교후문,365,1201,1566,37.4888154264,127.0298927879
22127,서초그랑자이아파트,1102,406,1508,37.4880013621,127.0260375466
22128,서초그랑자이아파트,560,993,1553,37.4876295809,127.0260531533
22129,남양시장.교문정형외과,547,258,805,37.484274561,127.030748275
22130,서초구청,92,374,466,37.4838578864,127.0305869863
22131,수협서초지점,997,1138,2135,37.493517,127.029385
22132,서초문화예술정보학교,489,804,1293,37.4880209971,127.0320161779
22133,법조단지,334,534,868,37.4963832763,127.012997468
22134,교대역10번출구,945,327,1272,37.4935537463,127.0127808558
22135,서초역.서울중앙지법등기국,1598,1073,2671,37.4930992018,127.0073275332
22136,서초역1번출구,823,1319,2142,37.4920156317,127.0089105135
22137,서울중앙지방검찰청,157,347,504,37.494768,127.006543
22138,서울중앙지방검찰청대검찰청,173,397,570,37.494383,127.006115
22139,서초아트자이아파트,952,958,1910,37.4858593343,127.0108432502
22140,서초동삼성아파트,638,843,1481,37.4889206373,127.0093426497
22141,서초유스센터.서초아트자이,840,653,1493,37.4854801487,127.0105005709
22142,서초동삼성아파트,601,801,1402,37.4885115912,127.0089653123
22143,서초3동주민센터,580,553,1133,37.4831290593,127.0116355253
22144,서초3동주민센터,438,352,790,37.4832218285,127.0120799291
22145,서초동예술의전당,514,678,1192,37.4816857308,127.0128860369
22146,서초중학교,1241,1160,2401,37.4836051072,127.0085384266
22147,서초중학교,1263,1019,2282,37.4833879213,127.0088052622
22148,서울고등학교,1189,850,2039,37.4829303821,127.0050002096
22149,서울고등학교,1150,852,2002,37.4827474318,127.0055791438
22150,상문고교,185,251,436,37.4819049356,127.0047242402
22151,서초동예술의전당,51,183,234,37.4794328531,127.0112295473
22152,서초동예술의전당,822,442,1264,37.4796986297,127.0108027917
22153,남부터미널.기쁨병원,123,192,315,37.4819578926,127.01686616
22154,남부터미널.기쁨병원,123,146,269,37.4817361133,127.0176022215
22156,남부터미널.한일시멘트,1700,607,2307,37.4847318427,127.014218486
22157,남부터미널,2313,2264,4577,37.4847528138,127.0156031956
22158,서울교대사거리,116,207,323,37.4873846428,127.0146475713
22159,서울교대사거리,342,265,607,37.4880507136,127.0133427182
22160,서울교대사거리,580,433,1013,37.4878368141,127.0131388831
22161,교대역14번출구,670,463,1133,37.491176,127.013952
22162,KCC사옥,66,424,490,37.5030340451,127.0202806592
22163,서초푸르지오써밋,112,201,313,37.501368,127.021952
22164,서초푸르지오써밋.롯데캐슬클래식,338,412,750,37.5014758287,127.0221683272
22165,진흥아파트,179,330,509,37.497723339,127.0237030894
22166,진흥아파트,319,230,549,37.497888115,127.0239008182
22167,환경관리사업소.구리시곤충생태관,1343,592,1935,37.4977839964,127.0266040758
22168,서초동진흥아파트,369,197,566,37.4965791206,127.0227753379
22169,서초동유원아파트,464,425,889,37.4957579984,127.0197669475
22170,교대역4번출구,726,719,1445,37.4944725735,127.0158386954
22171,법조단지,273,706,979,37.4962850117,127.0132446587
22172,신논현역.구교보타워사거리,1471,721,2192,37.5026203992,127.0251067731
22173,강남역10번출구,442,859,1301,37.5001,127.026307
22174,잠원한신아파트,426,884,1310,37.5165006388,127.0100874797
22175,래미안신반포리오센트아파트,473,550,1023,37.5196287069,127.0139080104
22176,신반포18차아파트,538,369,907,37.5201580118,127.0141965647
22177,롯데캐슬아파트,240,195,435,37.5196944471,127.0155351771
22178,롯데캐슬아파트,212,215,427,37.519963891,127.0154198388
22179,신반포르엘아파트,199,219,418,37.5166395426,127.0144013886
22180,신반포르엘아파트,308,170,478,37.517676,127.01457
22181,신동중학교,335,193,528,37.5155920192,127.0132333639
22182,신동중학교,210,286,496,37.5154999599,127.013019307
22183,논현역7번출구,1644,2374,4018,37.5106629516,127.0193580416
22185,신사역4번출구,942,721,1663,37.5149854627,127.0196984948
22186,신사역5번출구,239,648,887,37.5169785253,127.0189942083
22190,논현역6번출구,1657,1576,3233,37.5102908187,127.0192130073
22191,논현역4번출구,442,186,628,37.5091091024,127.0219545344
22192,신논현역2번출구,140,190,330,37.505962,127.023498
22193,신논현역1번출구,285,198,483,37.504227,127.023023
22194,제일약품사옥,990,184,1174,37.503387186,127.0202524387
22195,사평역,217,261,478,37.5049175628,127.0138854889
22196,사평역,239,346,585,37.5038158427,127.0158022515
22197,디에이치반포라클라스,522,1297,1819,37.4996628214,127.012449163
22199,삼호가든사거리.반포도서관,1145,583,1728,37.5027974539,127.0116012521
22200,신반포역4번.래미안퍼스티지,608,356,964,37.5028527245,126.9951595801
22203,서초구민체육센터.심산문화센터,143,185,328,37.4983902105,126.9905148116
22204,잠원한신아파트,754,328,1082,37.5167954603,127.0098410017
22205,잠원성당.아크로리버뷰아파트,619,335,954,37.5136804627,127.0066452278
22206,잠원성당,401,833,1234,37.5134704636,127.0069649098
22207,뉴코아아울렛,933,1018,1951,37.5092091078,127.0077585838
22208,신반포자이아파트,794,700,1494,37.5094758176,127.0080006792
22211,반포자이아파트,187,107,294,37.5061556046,127.0094829161
22212,서울지방조달청.서울성모병원,1043,835,1878,37.4992622494,127.0039326529
22213,센트럴시티,428,36,464,37.5035554381,127.0063361465
22214,서울지방조달청.서울성모병원,671,1242,1913,37.5006745712,127.0040910539
22215,서울성모병원,439,408,847,37.502759,127.005482
22217,서초구민체육센터.심산문화센터,545,327,872,37.4979605693,126.9910968933
22218,반포미도아파트앞,1141,1181,2322,37.5017017153,127.0115829859
22220,고속터미널호남선,474,925,1399,37.5053517067,127.0030788422
22221,삼호아파트,577,943,1520,37.496634,126.987806
22222,방배사이길,966,1077,2043,37.4933287858,126.9902779847
22223,방배동삼호아파트,794,505,1299,37.4965316814,126.9882533589
22224,가야메디컬센터,962,856,1818,37.493391877,126.9898749163
22225,이수교,2022,1167,3189,37.4968566323,126.983268857
22227,한양대구리병원.중앙예식장,333,228,561,37.4972742389,126.9852046016
22228,한국제약바이오협회,366,498,864,37.4823078119,127.0016995144
22229,방배역.방배서리풀이편한세상,1403,579,1982,37.4835892379,126.9964723757
22230,내방역2번출구,899,806,1705,37.4867753694,126.9943843705
22231,내방역,1731,1033,2764,37.4866230686,126.9940948938
22232,방배1동주민센터.방배아크로타워,506,841,1347,37.4834494617,126.9961463518
22233,한양대구리병원.중앙예식장,1106,1442,2548,37.481350238,126.9967155632
22234,서울교통공사사당별관,216,519,735,37.4767111473,126.9861651981
22235,종로교회,69,313,382,37.4786416232,126.9890955981
22236,대우효령아파트,206,368,574,37.4802035565,126.9933660869
22237,이수중학교,91,198,289,37.4809100052,126.9930505516
22238,방배브라운가아파트,61,118,179,37.4840628359,126.9910193885
22241,사당역,875,1276,2151,37.4790017977,126.9820916177
22244,경남임광아파트,489,356,845,37.4772016189,127.0006312978
22245,방배그랑자이아파트,98,206,304,37.4772529436,127.000279812
22246,서울지방법무사회,297,190,487,37.4800397349,126.998755084
22247,현대멤피스2차아파트,89,187,276,37.4798144548,126.998445273
22248,한국제약바이오협회,900,1648,2548,37.482269,127.002689
22249,방배역.백석예술대학교,1053,827,1880,37.4810371386,126.9967608013
22250,방배동대우효령아파트앞,220,315,535,37.4801667639,126.9940942526
22251,종로교회앞,355,166,521,37.4780946163,126.9887157676
22252,서울교통공사,343,149,492,37.4763264038,126.9864140138
22253,방배동래미안아트힐.국립국악원,879,744,1623,37.4775028061,127.0063000295
22254,방배그랑자이아파트,149,102,251,37.4748187293,127.0008920712
22255,성뒤마을.교육연수원,119,138,257,37.4737471951,126.994632951
22256,방배동래미안타워,211,194,405,37.4746741807,126.990586349
22257,대항병원,249,370,619,37.4756416406,126.9871072248
22258,대항병원,135,162,297,37.4753865896,126.9867646835
22259,방배동래미안타워.동덕여중고,100,98,198,37.4742876115,126.9906564963
22260,성뒤마을.교육연수원,59,212,271,37.4733920819,126.9971426734
22261,방배그랑자이아파트,41,305,346,37.4747736656,127.0016642941
22262,방배동래미안아트힐.국립국악원,278,626,904,37.4772752708,127.0068455026
22263,서문여고입구,204,159,363,37.490238,126.987153
22264,방배동고개,168,136,304,37.4867535988,126.9893092646
22267,예술의전당,430,240,670,37.4804147333,127.0133439181
22268,방배열린문화센터,536,435,971,37.4905049074,126.9920624118
22269,방배열린문화센터,547,419,966,37.4906184149,126.991605527
22270,양재역.양재1동민원분소,2272,1719,3991,37.484769125,127.0374188123
22271,양재노인종합복지관,348,930,1278,37.4833239776,127.0421051056
22272,블랙야크양재사옥,664,330,994,37.4801407005,127.0411738713
22273,현대빌라.에코나우,135,693,828,37.4761397871,127.0356382501
22274,현대빌라.에코나우,241,144,385,37.4763036239,127.0360924585
22275,우성아파트.양재초등학교,132,465,597,37.4745861729,127.0318295981
22276,우성아파트.양재초등학교,457,88,545,37.4746647587,127.0327538269
22277,코오롱아파트.양재1동주민센터,25,346,371,37.4723552457,127.0281898414
22278,우면코오롱아파트,773,154,927,37.4720372808,127.0280952447
22279,우면주공아파트.우면한라아파트,577,1410,1987,37.4707123,127.0256888887
22280,우면주공아파트.양재1동주민센터,1781,560,2341,37.4707830522,127.0261417924
22281,서울AI허브.한국교원단체총연합회,76,237,313,37.4670266951,127.0276019229
22282,서울AI허브.한국교원단체총연합회,126,26,152,37.4669159933,127.0278540505
22283,네이처힐3.4단지,1299,432,1731,37.4653477001,127.0261568554
22284,성촌마을입구,15,294,309,37.4653569682,127.0249643139
22285,송동마을.서초힐스아파트,544,1065,1609,37.459029969,127.0179066267
22286,송동마을.서초힐스아파트,691,293,984,37.45850283,127.0178420688
22287,식유촌우면성당.서초호반써밋,139,61,200,37.4575011395,127.012719512
22288,식유촌우면성당.서초호반써밋,443,595,1038,37.4572390563,127.0142946658
22289,양재역,6841,2198,9039,37.4836855552,127.0347109627
22290,양재역,814,1535,2349,37.4834352902,127.0355022994
22291,말죽거리공원사거리,694,1091,1785,37.4789316238,127.0383011771
22292,말죽거리공원사거리,391,420,811,37.479564487,127.038595453
22293,양재2동주민센터.양재꽃시장,1898,1560,3458,37.4695857229,127.0394643327
22294,매헌시민의숲,186,787,973,37.473135,127.038353
22295,언남고교,994,214,1208,37.4732795382,127.0389281035
22296,매헌시민의숲.양재꽃시장,6,43,49,37.470867,127.03836
22297,매헌시민의숲.양재꽃시장,111,27,138,37.471255,127.039043
22298,AT센터.양재꽃시장,1505,1139,2644,37.468707,127.039655
22299,양곡도매시장,246,266,512,37.4603469913,127.0351946776
22300,양곡도매시장,181,189,370,37.4600226101,127.0352510403
22301,하나로마트.코트라,817,1352,2169,37.4638411943,127.0444478156
22302,코트라,1844,796,2640,37.4648670188,127.0442708153
22303,구룡사앞,46,236,282,37.47021,127.048848
22304,구룡사,25,563,588,37.474022,127.048132
22305,구룡사입구,116,358,474,37.472103,127.050237
22306,동원산업앞,87,1528,1615,37.4766473684,127.0453961106
22307,언남고포이성당앞,1001,32,1033,37.4720326359,127.0458263366
22308,양재119안전센터앞,201,144,345,37.4694948049,127.0412468009
22309,양재119안전센터앞,452,182,634,37.4700464462,127.0418942836
22310,꽃마을,12,22,34,37.4606337119,127.0463678573
22311,꽃마을,14,25,39,37.4604305782,127.0465822876
22312,개나리골입구,5,20,25,37.4574411837,127.0476271592
22313,개나리골입구,14,8,22,37.4572835336,127.0480329114
22314,새원마을,3,44,47,37.4542914263,127.0507075609
22315,새원마을,20,1,21,37.4544761173,127.0507924603
22316,본마을,11,97,108,37.4532630544,127.051184988
22317,본마을,75,9,84,37.4534550903,127.0513419343
22318,청계산.원터골,16,122,138,37.4444526002,127.0577012426
22319,청계산.원터골,126,36,162,37.4448950615,127.0576688071
22320,관현사입구,7,37,44,37.4373210738,127.0632387636
22321,관현사입구,20,5,25,37.4371542291,127.0637037462
22322,새쟁이마을,4,60,64,37.4345128931,127.0661788352
22323,새쟁이마을,51,7,58,37.4347964213,127.0660515509
22324,옛골,145,6,151,37.4309469125,127.0704380789
22325,염곡마을.서초50플러스센터,5,31,36,37.4615900526,127.0488127592
22326,염곡마을.서초50플러스센터,34,22,56,37.46200197,127.0491561488
22327,탑성마을,3,30,33,37.4583767151,127.0566180036
22328,탑성마을,1,4,5,37.459472271,127.0548668871
22330,안골마을,219,0,219,37.4562835966,127.0623888747
22331,서울특별시어린이병원.강동송파과학화예비군훈련장,57,45,102,37.456646235,127.0702106955
22332,서울특별시어린이병원.강동송파과학화예비군훈련장,22,57,79,37.4575866482,127.0718263325
22333,헌인릉.강남서초과학화예비군훈련장,85,196,281,37.459744,127.079544
22334,헌인릉.강남서초과학화예비군훈련장,146,116,262,37.4611155017,127.0826829531
22335,헌인농장,47,70,117,37.4614213099,127.0847576347
22336,헌인마을.서울농업기술센터,61,99,160,37.4636402535,127.0914525016
22337,헌인마을.서울농업기술센터,81,91,172,37.4633434186,127.0895910466
22338,서초소방서,65,342,407,37.4983505745,126.992551994
22339,강남역8번출구,1192,679,1871,37.4975009943,127.0268505284
22340,방배동래미안타워.동덕여중고,439,343,782,37.4747183321,126.9905512938
22341,옛골,3,185,188,37.4305199435,127.0708456635
22343,헌인가구단지,8,3,11,37.459688,127.086699
22345,교대역5번출구,950,799,1749,37.4937995917,127.0147370359
22347,서초힐스아파트,420,379,799,37.4577874974,127.016833601
22348,강남역7번출구,134,621,755,37.4969583114,127.0277969551
22363,사당역1번출구,522,22,544,37.4761745327,126.9827009681
22364,남부시장,105,0,105,37.4950765232,126.985816874
22365,강남의림한방병원,274,73,347,37.4908097066,126.9834174392
22367,염곡동구룡사,220,35,255,37.468475,127.047211
22368,국제전자센터,1428,944,2372,37.485159,127.017723
22369,염곡동구룡사,23,1,24,37.4683281101,127.0471332159
22372,형촌마을입구,163,126,289,37.4636885353,127.0214455478
22376,국제전자센터,531,1231,1762,37.4854351267,127.0177580083
22378,도로교통공단서울지부.코트라,218,1329,1547,37.4662408667,127.0443893195
22379,서초역3번출구,1366,577,1943,37.4911256302,127.0077359676
22380,서초구민체육센터,178,174,352,37.4983811835,126.9903056015
22381,반포대교남단.한강시민공원입구,463,1040,1503,37.5078106042,126.9994684234
22382,반포대교남단.한강시민공원입구,751,377,1128,37.5069439929,127.0003902363
22384,하이브랜드,545,45,590,37.4620911714,127.0367880249
22385,이수역5번출구,904,256,1160,37.485489363,126.9842072627
22386,방배초등학교,224,131,355,37.4856847977,126.9863829259
22387,방배고개,256,275,531,37.4864946348,126.9901827615
22389,내방역3번출구,849,201,1050,37.4867762516,126.9939998932
22390,방일초교,111,345,456,37.4859520772,126.9949486673
22391,내방역,562,975,1537,37.487533232,126.9927493333
22392,방배고개.방배초등학교,212,520,732,37.4863886439,126.9888061591
22393,이수역,184,719,903,37.4858655917,126.9846453233
22394,방배역,388,204,592,37.481444879,126.9984199634
22395,방배역,274,275,549,37.482323341,126.9972384369
22396,동작대교전망카페,51,74,125,37.5057628053,126.9802792405
22397,동작대교전망카페,24,54,78,37.5058583711,126.9808128467
22400,삼성래미안아파트,66,71,137,37.4949659925,127.0184931133
22401,청계산입구역,262,354,616,37.4484508233,127.0544463432
22402,청계산입구역,154,96,250,37.4494760752,127.053684245
22403,서초포레스타7단지,209,59,268,37.4475718103,127.0555729873
22404,반포한강공원.세빛섬,161,268,429,37.5126669883,126.9972655964
22405,반포한강공원.세빛섬,289,196,485,37.5122480317,126.9977548042
22408,신논현역.유화빌딩,15,0,15,37.5015319154,127.0255490162
22415,내방역1번출구,559,259,818,37.4879838668,126.9953442808
22416,매헌시민의숲,4,20,24,37.4730822004,127.0389144339
22417,동덕여중고,321,344,665,37.4741688,126.9924723
22418,유경약국,180,1,181,37.4936654408,126.9862027844
22419,남부터미널,82,287,369,37.4846839172,127.0155437556
22420,동부센트레빌2,255,147,402,37.4980323894,126.9880579276
22421,헌인마을.서울농업기술센터,14,1,15,37.4633816966,127.0896108732
22422,잔디마을,288,19,307,37.4635271111,127.0352320779
22423,방일초등학교,105,97,202,37.4852218926,126.9950041608
22424,네이처힐5단지,896,1026,1922,37.4633118929,127.0238954595
22426,대법원앞,647,120,767,37.4916688995,127.0065302002
22427,교육개발원입구사거리,361,1101,1462,37.4795630391,127.0386622548
22429,방배래미안타워,224,91,315,37.4746336482,126.9908068274
22431,이수중앙시장,305,289,594,37.4921140295,126.9889556704
22432,국제전자센터,174,41,215,37.485082815,127.0176222301
22433,방배신삼호아파트,235,149,384,37.4979488983,126.9916917922
22434,헌인릉.꽃시장,1,1,2,37.461503,127.08362
22435,더케이호텔후문,112,15,127,37.4653349981,127.0343341849
22436,방배1동주민센터.방배아크로타워,227,274,501,37.4834901203,126.9962575574
22437,삼성레포츠,84,203,287,37.4922064267,127.0208164268
22439,원불교,354,352,706,37.4833310663,127.0424409464
22440,양재역7번출구.프라자약국,788,3508,4296,37.48382,127.035091
22442,서울교통공사사당별관,38,43,81,37.476277741,126.9863880175
22443,방배초등학교,40,19,59,37.4857351563,126.9863639853
22445,함지박사거리,169,138,307,37.4930288433,126.9912671152
22446,서일초등학교,70,70,140,37.4861131293,127.0209866183
22447,이수화학,156,79,235,37.4980301028,126.9933543313
22448,예비군훈련장,75,185,260,37.455543466,127.0807710572
22449,더케이호텔정문,8,13,21,37.468301508,127.0341150869
22450,방배역1번출구,2241,969,3210,37.4814094121,126.9984655932
22451,대림약국,44,219,263,37.4904459771,127.0208116389
22452,반포래미안아이파크아파트,86,424,510,37.5009627535,127.0121585657
22455,방배고개,14,50,64,37.4862118385,126.9894179086
22456,함지박사거리,159,21,180,37.4922655561,126.9905852724
22457,서래초교,61,72,133,37.4952967316,126.9889993086
22458,방배성당앞,46,117,163,37.4936363379,126.9936238794
22459,현대아파트.한국상담대학원대학교,45,49,94,37.4868903084,127.0235051656
22460,한국회관.ROTC중앙회,204,105,309,37.4987042254,126.9954070281
22461,신흥마을입구,4,6,10,37.4586102133,127.0816843202
22462,예술공원,5,1,6,37.4699888265,127.0325353274
22464,사당역13번출구,49,14,63,37.4771120126,126.9826432124
22466,서초구립반포도서관.반포리체,150,121,271,37.5026207465,127.0124970198
22468,서초문화예술정보학교후문,133,72,205,37.4867142254,127.0291942381
22471,장자터빌딩,16,38,54,37.485106263,126.9903543589
22473,동부센트레빌1,23,22,45,37.4976529669,126.9874958912
22474,필리핀대사관,108,178,286,37.4939491206,126.9958664743
22475,서초그랑자이아파트,81,32,113,37.4877448571,127.0263472092
22476,신반포역4번.래미안퍼스티지,551,453,1004,37.5026950589,126.9954197057
22478,kt연구소,14,14,28,37.4717085715,127.0309238538
22479,상문고등학교,292,503,795,37.4821455353,127.0046089193
22486,백산빌딩,39,88,127,37.4791373946,126.9910358078
22487,방배브라운가아파트,35,55,90,37.4841087897,126.9909865905
22488,방배열린문화센터.가야치과병원,166,77,243,37.4893578225,126.9923780416
22489,방배중학교,94,326,420,37.495387339,126.9981113214
22491,반포래미안,116,50,166,37.5045840073,127.0003970105
22493,우성아파트,966,288,1254,37.4746627796,127.0328539307
22494,삼환아파트,205,427,632,37.4800296953,127.0056275624
22496,반포래미안아이파크아파트후문,58,34,92,37.5020978707,127.0145622236
22497,반포고교,30,35,65,37.5017030173,127.0158854643
22499,서초문화예술정보학교,100,46,146,37.488062923,127.0321660498
22500,교총회관,157,102,259,37.4668240829,127.0277462709
22501,대우효령아파트,85,158,243,37.4799386393,126.9935074494
22502,동문빌라,19,57,76,37.4829808269,126.9918254753
22503,효성빌라,173,142,315,37.4966719096,126.9983320021
22504,서초포레스타3단지정문,7,189,196,37.4554282126,127.0593384984
22505,호남고속터미널,202,456,658,37.5054364064,127.0032236261
22506,서초포레스타3단지정문,194,12,206,37.455326281,127.0595497917
22507,현대빌라.에코맘코리아,492,274,766,37.4762932882,127.0360835343
22508,방배빌딩.방배아트힐아파트정문,362,598,960,37.4782806055,127.0064743162
22510,반포고교,83,25,108,37.5012857723,127.0161409896
22512,언남초등학교,9,123,132,37.4543079703,127.061421935
22513,서초2동주민센터,408,130,538,37.4917135401,127.0253409803
22515,삽준네마을,252,162,414,37.4692693783,127.0268099021
22516,방배역.백석대,121,238,359,37.4809786482,126.9967265422
22517,이수중학교,50,76,126,37.4818561289,126.9924466481
22518,서래마을.서래글로벌빌리지센터,121,180,301,37.4978969161,126.9984381123
22519,언남초등학교,115,5,120,37.4545735009,127.0616322756
22520,경부고속터미널,166,9,175,37.5065337938,127.0068477606
22521,서초더샵포레,6,115,121,37.4544989777,127.0643010736
22525,반포센트럴푸르지오써밋아파트,16,19,35,37.5009216068,127.0169971
22526,서초더샵포레,204,3,207,37.4547100295,127.0636983185
22528,양재시민의숲매헌역입구,3,56,59,37.4691694309,127.0375190241
22530,대우효령아파트,26,69,95,37.4801576456,126.9942333499
22531,서래마을입구,113,86,199,37.4991809877,126.9984335615
22532,강남역9번출구,595,786,1381,37.4977272396,127.0265475067
22533,반포자이아파트,169,56,225,37.5062258928,127.0094604316
22535,임광아파트후문,131,245,376,37.4758189221,127.0030267509
22536,방현초교,38,54,92,37.4758333144,126.9887116384
22537,세탁소,33,69,102,37.4825486576,126.9874848398
22538,현대4차아파트,108,76,184,37.5005700292,127.0179934519
22539,반포자이아파트,11,90,101,37.5056333558,127.0101482277
22540,서초1동주민센터,47,52,99,37.4895945167,127.01846691
22541,매헌시민의숲,18,7,25,37.4729579873,127.0383858588
22543,서래마을입구,373,109,482,37.4999036726,126.9984708699
22544,팔래스호텔,238,80,318,37.5005416631,127.0000689924
22546,반포미도아파트앞,491,271,762,37.5018431861,127.0116067597
22547,여의3교,13,6,19,37.4525340361,127.0557998691
22548,임광아파트정문,405,139,544,37.4765668747,127.0010130728
22549,대성유니드아파트,1,1,2,37.4834866466,126.9869170389
22550,서초래미안아파트정문,102,58,160,37.500285166,127.0187319391
22551,뉴코아백화점,72,147,219,37.5093091088,127.0080753177
22552,서울교대정문,96,120,216,37.4889577449,127.0163712913
22553,일동제약,199,411,610,37.4773511613,127.0376175038
22554,롯데캐슬클래식.사랑의교회,0,33,33,37.4997374512,127.02295725889999
22555,반포래미안아이파크아파트,294,169,463,37.5003518259,127.0120274955
22556,언남중고교,756,213,969,37.4718794592,127.0457968477
22557,방배3동주민센터,137,117,254,37.4784490339,126.9998162822
22558,우리수퍼,2,1,3,37.4846706169,126.986197654
22559,서초래미안아파트남문,42,41,83,37.4974383029,127.0204175134
22560,경원중학교,0,11,11,37.5118733237,127.00955354
22561,청호나이스,218,126,344,37.4879588324,127.0130611243
22562,구름다리,78,152,230,37.4799007004,126.99213624
22563,서울지방조달청.서울성모병원,511,170,681,37.4995235403,127.0039609388
22565,아크로비스타.미도아파트,77,75,152,37.4980458485,127.0124973884
22566,방배역,40,257,297,37.4809786782,126.9980947232
22567,잠원역,42,26,68,37.5128516004,127.0115251789
22570,주택단지,53,37,90,37.4786803776,126.9891702182
22571,국립중앙도서관,177,167,344,37.4979220747,127.0044198835
22572,반포1동성당,94,43,137,37.5041168276,127.0207027838
22573,여의3교,5,18,23,37.4522824107,127.0558843017
22574,방배역.서초프라자약국,879,163,1042,37.4822348038,126.9973009069
22575,동덕여고,82,49,131,37.474535574,126.9929346869
22576,이수역4번출구,37,879,916,37.4855775952,126.9828785969
22577,신사역,163,27,190,37.515341378,127.019585476
22578,유원아파트,25,52,77,37.4955095778,127.0178666711
22579,서초역2번출구,174,285,459,37.4912987658,127.0081468857
22581,국립국악원,89,91,180,37.478170527,127.0087096724
22582,종로교회,21,56,77,37.4781116779,126.9881108486
22583,서초푸르지오써밋,188,2,190,37.5019661186,127.0216821231
22584,원불교,111,78,189,37.4809910796,127.0419262722
22585,일동제약,106,420,526,37.4771882391,127.037054348
22586,방일초등학교,110,277,387,37.4858436536,126.9949735878
22587,논현역,879,112,991,37.5102896713,127.0214930177
22591,청계산입구역,30,122,152,37.448957246,127.0553027816
22592,예술의전당,218,173,391,37.480583233,127.0135449202
22593,서울교통공사,94,140,234,37.4774465285,126.9868536435
22594,경원중학교,28,34,62,37.5114970568,127.0068991175
22595,대법원,237,380,617,37.4916070459,127.0064912987
22596,롯데캐슬클래식,16,5,21,37.500431,127.022435
22598,청계산입구역,56,62,118,37.4491308269,127.0550119009
22599,내방역,289,436,725,37.4868492575,126.9943312166
22601,KT삼거리,6,26,32,37.472187,127.03021
22602,KT연구개발센터정문,55,52,107,37.4704352425,127.0300162908
22604,형촌마을입구,596,491,1087,37.4623284779,127.0221930408
22605,서초호반써밋,280,223,503,37.4576416633,127.0146667957
22607,호반써밋서초파크.파크뷰,303,171,474,37.4600431105,127.0256209436
22608,서리풀문화광장,65,820,885,37.4910022065,127.0054983231
22609,서초포레스타5단지정문,1,6,7,37.4517646373,127.0584580212
22613,옛골,1,44,45,37.4563449238,127.0151305788
22614,서초포레스타3단지후문,0,27,27,37.453804,127.059588
22615,서초힐스아파트,0,22,22,37.4564627414,127.0195785878
22616,LH3.4단지,2,142,144,37.4579545688,127.0229572647
22631,교보사거리,76,131,207,37.50605355,127.023552815
22641,서초IC,0,1,1,37.4823590858,127.0266045342
22654,강남역티월드,0,179,179,37.4946974423,127.0288669116
22655,LH5단지,104,11,115,37.4595010532,127.0240810088
22656,LH3.4단지,155,1,156,37.4579865593,127.0227161524
22657,서초힐스아파트,6,5,11,37.4561419958,127.0173599771
22667,성촌마을입구,1169,1466,2635,37.4642970776,127.0246982574
22694,2호선교대역7번출구,114,85,199,37.4940798561,127.0145663212
22742,서초경찰서,41,173,214,37.4956827639,127.0059940336
22743,원불교,267,597,864,37.4834141055,127.0420565333
22759,남부터미널.기쁨병원,23,56,79,37.4818370058,127.0178114323
22774,삼성전자서울R&D,66,138,204,37.4658469816,127.0233096227
22776,사당역13번출구,6,287,293,37.4770820069,126.9831179759
22779,네이처힐.호반써밋서초파크.파크뷰,116,239,355,37.4604668951,127.0241545233
22785,서초호반써밋,2,6,8,37.4564279225,127.0153740036
22807,한신2차후문,203,51,254,37.5121623419,127.0052284159
22832,서초고후문,56,86,142,37.4891146384,127.0044805259
22835,우성아파트,252,865,1117,37.4745387859,127.031814158
22836,내방역1번출구,461,459,920,37.48779237,126.994581062
22837,내방역8번출구,32,25,57,37.4883307454,126.9951096348
22838,교보타워앞,372,243,615,37.50327662,127.0248806477
22840,잠원역,0,1,1,37.5130042435,127.0114648241
22841,동원산업,491,2366,2857,37.4765950873,127.0454401748
22842,서울시인재개발원,109,120,229,37.4826059016,127.0216889654
22843,한신2차정문,79,35,114,37.5086507521,127.0030848753
22844,미켈란아파트,135,282,417,37.4862032326,127.0040324571
22845,롯데칠성,63,9,72,37.4954027722,127.0248050278
22847,kt연구소,6,59,65,37.471705038,127.0306513806
22848,오거리,11,72,83,37.4884884833,126.9969385684
22849,사당역,428,839,1267,37.4765962586,126.982757404
22850,강남역.서초초교앞,112,275,387,37.4998269766,127.0264996641
22852,경원중학교,1,1,2,37.5119708712,127.0092995579
22854,외교안보연구원.서초구청,154,356,510,37.4837943042,127.0305443725
22855,호남고속.신세계,480,383,863,37.5058391969,127.0032971651
22856,서울고사거리,92,135,227,37.4830538656,127.0041758943
22858,문화예술공원,2,13,15,37.4701430308,127.0321148241
22859,강남역.삼성전자,890,236,1126,37.4970515618,127.0278698411
22860,반포종합운동장,23,6,29,37.5005101566,126.9965026797
22861,반포종합운동장,170,762,932,37.4994762451,126.996273723
22862,언남중고교,153,826,979,37.471986729,127.0456985516
22863,서초구청,515,614,1129,37.4840614372,127.0324034746
22864,경남상가,126,129,255,37.5046903379,126.9998269439
22865,제약회관,118,140,258,37.482328536,127.001793367
22866,진흥아파트,116,18,134,37.4965521036,127.0226916384
22867,더케이호텔정문,6,46,52,37.4677292302,127.0343725873
22868,황실자이아파트,71,330,401,37.4892746444,126.9986374649
22869,우성아파트사거리,171,354,525,37.4937061909,127.0294488928
22870,서초역4번출구,45,218,263,37.4913844544,127.0068260214
22871,매헌초교,218,327,545,37.4704687607,127.0422086895
22872,반포2동주민센터,51,50,101,37.5038531775,126.9970535549
22873,방배역2번출구,666,219,885,37.4807240664,126.9980581848
22874,서초그랑자이후문,58,126,184,37.4897827638,127.0275420519
22875,유원아파트,122,54,176,37.4956521854,127.0194333246
22876,더케이호텔후문,5,130,135,37.4659938367,127.0341879129
22877,오거리,25,47,72,37.488815095,126.996800041
22878,파이낸셜뉴스.현대렉시온오피스텔,168,657,825,37.4910005915,127.0307255899
22879,서초역3번출구,1074,697,1771,37.4910843274,127.0077861115
22880,양재근린공원,161,86,247,37.4724090919,127.0415088094
22883,방배유스센터,15,101,116,37.478885422,126.9991553697
22884,서초그랑자이정문,117,76,193,37.488003615,127.026037547
22885,강남역10번출구,297,79,376,37.4992095778,127.0264405862
22887,뱅뱅사거리,44,184,228,37.4892316317,127.030304584
22889,언남고,182,64,246,37.4735942872,127.0433501089
22890,남부터미널.기쁨병원,84,152,236,37.4819795068,127.0169521013
22891,방배그랑자이아파트,44,282,326,37.477192125,127.0004098253
22892,풍림아이원,34,39,73,37.4872479803,127.0238377395
22893,하이브랜드.코스트코.이마트,48,371,419,37.4623679984,127.036183371
22894,서초유스센터,35,159,194,37.4861722268,127.0101625566
22895,예술의전당,142,859,1001,37.4811103218,127.0140414058
22897,교대역6번출구,1692,219,1911,37.494171868,127.0137373697
22899,신중초등학교,158,258,416,37.4796463752,127.0106964976
22900,동덕여고,588,541,1129,37.47403997,126.9929415
22901,국제전자센터,32,238,270,37.4854513228,127.0179151927
22904,국립국악원,70,129,199,37.4779435387,127.0073810943
22905,래미안아파트.파이낸셜뉴스,4,76,80,37.492482,127.029934
22906,삼호아파트,32,89,121,37.497427412,126.9873076156
22907,성지마을입구,2,0,2,37.4738661248,126.9924125075
22908,남부터미널.한일시멘트,170,124,294,37.4847552499,127.0143960237
22910,서초1동사무소,86,87,173,37.4903557536,127.0196816512
22911,양재시민의숲매헌역입구,44,9,53,37.4692956181,127.0373749569
22912,방배빌딩,234,238,472,37.478279901,127.0067664544
22913,서래초등학교,94,70,164,37.49573641,126.9883726975
22915,복지관,6,74,80,37.4916789581,127.016581893
22916,삼환아파트,260,124,384,37.4800107592,127.0058932787
22920,교육개발원입구사거리,53,121,174,37.4782102141,127.0394643451
22922,서초고후문,76,139,215,37.4893768961,127.0047484587
22923,상문고등학교.수표교교회,141,127,268,37.4818562644,127.0050035302
22924,빛교회.이수중앙시장,361,393,754,37.4922933558,126.9890268906
22925,현대캐피탈,24,85,109,37.4797190114,127.0410922289
22926,본마을노인복지센터,2,11,13,37.4544244544,127.0529606938
22927,본마을노인복지센터,6,1,7,37.4545394332,127.0530384779
22928,방배열린문화센터.가야치과병원,127,136,263,37.4891551044,126.9928643282
22929,카페골목입구,196,331,527,37.4916137524,126.9873182177
22930,원불교,33,72,105,37.481430551,127.0426750642
22931,방배열린문화센터,28,121,149,37.490394075,126.9921144436
22932,노인정,93,92,185,37.4893925216,126.9872326483
22933,뉴코아백화점,22,231,253,37.5072825331,127.0080547391
22934,함지박사거리,6,147,153,37.4915969962,126.9913600147
22935,청호나이스,179,277,456,37.4877164521,127.0129084201
22936,코오롱아파트,87,654,741,37.4723103108,127.0281179589
22937,이수역2번출구,2096,882,2978,37.4872077842,126.9824232165
22938,HCN서초방송,2,79,81,37.4822972976,127.0120492501
22939,서초포레스타3단지후문,37,0,37,37.4538837398,127.0595220597
22940,서울교대,97,93,190,37.4887252807,127.0162208382
22942,유경약국,0,169,169,37.4936339225,126.9863780826
22945,서초1동주민센터,66,84,150,37.4896367481,127.0192223339
22946,삽준네마을,103,187,290,37.4691973046,127.0267443044
22947,남부시장,0,110,110,37.4953901154,126.9858858024
22949,교총회관,104,277,381,37.4669560736,127.0275611985
22950,롯데캐슬헤론아파트,59,156,215,37.4973301255,126.9853504863
22956,서래마을입구,243,257,500,37.499217253,126.9983460816
22959,서래마을.서래글로벌빌리지센터,265,196,461,37.4979248474,126.9982345347
22961,서초문화예술정보학교후문,82,104,186,37.4866818374,127.0289838941
22963,효성빌라,281,167,448,37.4962866403,126.9981271322
22966,방배중학교,138,117,255,37.4949403792,126.9974474717
22968,필리핀대사관,92,138,230,37.4940689638,126.9957646844
22969,서초고후문,65,30,95,37.4889221759,127.0046620261
22970,방배4동성당,58,72,130,37.4937462678,126.9935356582
22972,함지박사거리,95,151,246,37.493124351,126.9911415729
22973,구룡사입구,5,246,251,37.4720524503,127.0502298295
22975,서문여고,7,120,127,37.4874536668,126.9850209583
22976,카페골목입구,312,303,615,37.4914704762,126.9873114566
22977,반포종합운동장,397,208,605,37.5002173346,126.9966723282
22979,서울교통공사,179,67,246,37.4774762857,126.9873538613
22980,서초구청맞은편,482,149,631,37.4841889736,127.030601072
22981,방배역3번출구,444,548,992,37.4812111266,126.9964879477
22982,서초롯데캐슬프레지던트아파트,41,42,83,37.496137355,127.0196986198
22983,대검찰청.서초경찰서,96,196,292,37.4945136356,127.0062446594
22984,불교TV.서초어린이집,180,308,488,37.4745006419,127.0002023829
22985,구룡사거리,245,980,1225,37.4739943247,127.0481441804
22986,서이초등학교,132,80,212,37.4911635361,127.0268380817
22987,서울고사거리,242,142,384,37.4832169599,127.0043330792
22989,사당역12번출구,2029,2171,4200,37.4778342637,126.9819882566
22990,삼성래미안.이수역방향,962,717,1679,37.503801116,127.001950895
22992,더미켈란아파트,484,371,855,37.4855580371,127.0041602025
22993,서울성모병원.서울지방조달청,361,744,1105,37.5003496563,127.0041236994
22994,아크로비스타,38,432,470,37.4980214836,127.01282537
22996,서초성당,71,202,273,37.4931966225,127.0212843629
22998,반포대교,1,16,17,37.5099152046,126.9974952936
23101,신사중학교,1309,2510,3819,37.5229277357,127.0204991277
23102,신사중학교,2123,913,3036,37.5238600208,127.0215476037
23103,광림교회.현대고등학교,1310,1432,2742,37.5253868122,127.0252663803
23104,광림교회.현대고등학교,1559,877,2436,37.5252779533,127.0244392928
23105,압구정역4번출구,2722,1276,3998,37.5257349597,127.0281887833
23106,국민은행압구정종합금융센터,1619,795,2414,37.5230982773,127.028118907
23107,신사동고개,802,1232,2034,37.5188969053,127.0257541709
23108,신사역8번출구.가로수길,1724,2385,4109,37.5174397364,127.0221753116
23109,신사역6번출구,483,288,771,37.517422,127.019435
23110,신사역3번출구,1959,1752,3711,37.5152289207,127.0200787646
23111,신사역1번출구,2580,1328,3908,37.5168574262,127.0217344165
23112,신사동고개,823,1715,2538,37.5185545148,127.0260152561
23113,강남을지병원,1224,1132,2356,37.5182204908,127.028629941
23114,학동역,2019,1581,3600,37.5147842255,127.0301678528
23115,학동역6번출구,477,478,955,37.5137805482,127.0296320997
23116,영동시장,257,395,652,37.5118508617,127.0234688746
23117,영동시장.논현역1번출구,714,778,1492,37.5113367768,127.0224536332
23118,학동역5번출구,1376,966,2342,37.5135731512,127.0301492658
23119,논현동고개,596,1337,1933,37.5102565309,127.0323028097
23120,삼정호텔,254,305,559,37.5067856544,127.0316905107
23121,신논현역3번출구,204,444,648,37.5050754793,127.0258483824
23122,신논현역3번출구.교보타워사거리,643,744,1387,37.5057773025,127.0241456343
23123,영동시장.논현역3번출구,480,1106,1586,37.5093462126,127.0223963092
23124,언북중학교입구,643,1268,1911,37.5202978876,127.0308205822
23125,도산공원사거리.호림아트센터,1130,1491,2621,37.5215790063,127.0349369258
23126,영동119안전센터,875,655,1530,37.5225557208,127.0381006504
23127,강남구청역,458,2414,2872,37.5185178636,127.0406416326
23128,강남구청역,936,360,1296,37.5169580553,127.0399409789
23129,세관앞,266,389,655,37.5157593644,127.0360665964
23130,서울세관,208,193,401,37.5170273453,127.0356282732
23131,서울세관,209,339,548,37.5173244793,127.0351676893
23132,학동역,1959,1930,3889,37.515158129,127.0303750209
23133,강남을지병원,587,1425,2012,37.5185664886,127.0287812765
23134,세관앞,346,434,780,37.5156009306,127.0364196087
23135,강남구청역,138,591,729,37.5167710194,127.0401699369
23136,한국토지주택공사앞,361,590,951,37.5131909081,127.0426620828
23137,선정릉역1번출구.시니어플라자,219,66,285,37.5102354545,127.0431015104
23138,아크로힐스논현,109,173,282,37.5092228723,127.0396748981
23139,논현아이파크,505,387,892,37.5112220456,127.0364372746
23140,임피리얼팰리스호텔.팬트힐루논현,177,360,537,37.5143285583,127.0356009719
23141,펜트힐루논현.임피리얼팰리스호텔,631,729,1360,37.5135465374,127.0351526376
23142,논현아이파크,276,587,863,37.5111433662,127.0359197745
23143,국민은행논현동지점,238,225,463,37.5085727966,127.0373832207
23144,언주역4번출구.차병원사거리,74,147,221,37.5078369128,127.0351434453
23145,언주역3번출구,1336,471,1807,37.5084783232,127.0335055792
23146,논현고개,480,881,1361,37.5114460374,127.0321076269
23147,서울세관사거리,116,199,315,37.515315407,127.0346068386
23148,현대아파트,2227,3188,5415,37.5284384777,127.030580671
23149,현대아파트,4365,2329,6694,37.5282986659,127.0311225746
23150,고속철도수서역,894,2055,2949,37.48487216,127.1043917485
23151,신사동교회,1182,700,1882,37.5206998289,127.030625028
23152,도산공원,364,345,709,37.5221138227,127.0333295289
23153,신구중학교,519,360,879,37.5267319814,127.0332342816
23154,압구정중고등학교.현대아파트,213,619,832,37.5297587463,127.0336829789
23155,도산공원사거리,1203,1176,2379,37.5220301368,127.0345957994
23156,압구정파출소,1689,1530,3219,37.5291115096,127.0362762745
23157,압구정파출소,1897,2281,4178,37.5287469102,127.0360581401
23158,한양아파트.압구정로데오역,2745,2190,4935,37.5282700029,127.0395789565
23159,한양아파트.압구정로데오역,2472,2259,4731,37.527929495,127.0392574486
23160,일지아트홀,2131,1155,3286,37.524911806,127.0395011945
23161,씨네시티앞,1608,1685,3293,37.5228970378,127.0375996828
23162,도산공원,528,679,1207,37.5228130189,127.0335300905
23163,신구중학교,398,521,919,37.5256460711,127.0335404098
23164,성수대교남단.현대아파트,765,290,1055,37.5299198087,127.0341408692
23165,청담초등학교,841,653,1494,37.5268028293,127.045122136
23166,청담동주민센터,2590,2914,5504,37.5246152832,127.0493317535
23167,청담동주민센터,3077,2191,5268,37.5245198173,127.0513510007
23168,영동교입구.청담자이아파트,372,509,881,37.522598,127.056049
23169,영동교입구,1209,1150,2359,37.522801,127.05519
23170,청담역.경기고교,1276,1192,2468,37.52098119,127.0561675414
23171,우리은행청담지점.청담삼익아파트,838,723,1561,37.5210776985,127.0568972469
23172,청담역.경기고교,779,1797,2576,37.5200284066,127.0561102673
23173,진흥아파트,873,839,1712,37.5192911033,127.0520898501
23174,청담동성당,608,426,1034,37.5204992022,127.0495735347
23175,청담2치안센터,271,548,819,37.5230254757,127.0482136037
23176,강남구청.강남세무서,2432,1250,3682,37.5184307316,127.0472972241
23177,청담동래미안아파트,907,1157,2064,37.5176597984,127.0429049989
23178,강남구청역,2447,1055,3502,37.518511943,127.0409428973
23180,농협앞,779,846,1625,37.5240778005,127.0443867144
23181,일지아트홀.압구정노인복지관,1403,1831,3234,37.5243159636,127.0396345679
23182,청담초등학교앞,911,1201,2112,37.5264613268,127.045085725
23183,청담2치안센터,591,350,941,37.5229351646,127.0477909496
23184,청담동성당,155,307,462,37.5202583193,127.0492045241
23185,차병원차움,483,678,1161,37.5236666735,127.044171112
23186,진흥아파트청담역,1556,1375,2931,37.5190458844,127.0521305938
23187,청담역.경기고교,1385,739,2124,37.5198187578,127.0564579528
23188,청담역.경기고교,197,910,1107,37.5193090138,127.0578574132
23189,봉은사.삼성1파출소앞,1656,4620,6276,37.5149677625,127.0594353837
23190,봉은사.코엑스북문,393,127,520,37.5141705618,127.0588290285
23191,봉은사.코엑스북문,87,227,314,37.5135467163,127.057639012
23192,봉은사역3번출구.삼성1파출소,5376,1858,7234,37.5151079658,127.0601628839
23193,봉은사역5번출구.광동병원,332,430,762,37.514457156,127.0621999736
23194,노블발렌티웨딩홀,220,231,451,37.5148306999,127.0647588832
23195,서울의료원강남분원,145,58,203,37.512568,127.065604
23196,강남경찰서면허시험장,1139,1686,2825,37.5098983164,127.0659088469
23197,삼성역7번출구,3827,1232,5059,37.5103989366,127.0626911632
23198,무역센터,1008,2242,3250,37.512027938,127.0610582829
23199,무역센터,1223,1068,2291,37.5103013849,127.0619901081
23200,강남구보건소,883,548,1431,37.5154775223,127.0417754477
23201,한국무역센터.삼성역,2211,1643,3854,37.508448,127.060899
23202,포스코사거리,1667,519,2186,37.5078226593,127.0563179719
23203,한별구립어린이집,783,517,1300,37.5104103876,127.0549014268
23204,센트럴아이파크.강남구도시관리공단,306,1049,1355,37.5157795361,127.0520466841
23205,삼성동서광아파트,1913,1034,2947,37.5173233382,127.0424517989
23206,강남구청.강남세무서,1341,1618,2959,37.5182413732,127.0476647353
23207,청담역7번출구,1272,290,1562,37.5176356522,127.0506188246
23208,센트럴아이파크.강남구도시관리공단,504,412,916,37.5153174045,127.0518696115
23209,한별구립어린이집,385,800,1185,37.5102276026,127.0546026643
23210,삼성중앙역.플래티넘아파트,720,247,967,37.512663758,127.0515286905
23211,삼성중앙역.플래티넘아파트,258,492,750,37.5123779785,127.0518271312
23212,삼성2문화센터,404,209,613,37.5110917636,127.0461375271
23213,삼성2문화센터,233,369,602,37.5108104729,127.046512905
23214,선릉역8번출구.선정릉,1638,955,2593,37.5062014334,127.0483328457
23215,선정릉역.국가무형유산전수교육관,859,1247,2106,37.5097642558,127.0441954871
23216,한국토지주택공사앞,565,620,1185,37.5126364282,127.0432054996
23217,포스코건너편,3113,1844,4957,37.5066831874,127.0554269279
23218,선릉역,2041,1677,3718,37.505143,127.050205
23219,도곡역2번출구.동부센트레빌,458,470,928,37.4915855937,127.0565229085
23220,중대부고,1431,620,2051,37.4918872375,127.0550936879
23221,단대부고.대치아이파크아파트,542,815,1357,37.4946749575,127.0537770662
23222,한티역3번출구.서울강남고용노동지청,2620,1468,4088,37.4964463596,127.0541425059
23223,삼성아파트입구,1681,2726,4407,37.4981982,127.05956007
23224,농협대치지점,1931,1635,3566,37.4979369667,127.0611545494
23225,대치SKVIEW아파트.서울교회,547,1024,1571,37.4962613463,127.0620556876
23226,대치역1번출구,1352,1247,2599,37.4938592964,127.0614984174
23227,래미안대치팰리스,811,511,1322,37.4925595861,127.0585796232
23228,도곡역3번출구,444,535,979,37.4911818874,127.0565474837
23229,대치동우성아파트,516,669,1185,37.4925770923,127.0596110202
23230,대치역8번출구,892,883,1775,37.4938624098,127.0622309495
23231,대치역7번출구.선경아파트,665,576,1241,37.492458,127.06408
23232,대청중학교,367,1885,2252,37.4902578609,127.0557033053
23233,은마아파트,2190,930,3120,37.4955959062,127.0628615031
23234,은마치안센터,1013,941,1954,37.4980989737,127.0615233829
23235,은마아파트,695,708,1403,37.4994819598,127.0631318417
23236,대치동은마아파트,797,1116,1913,37.4989023513,127.0684549688
23237,은마아파트,753,683,1436,37.4957666584,127.0669737834
23238,대치동미도아파트,620,672,1292,37.4956049426,127.0677076244
23239,대치역6번출구.강남구민회관,649,717,1366,37.492785,127.064278
23240,쌍용아파트,1072,726,1798,37.4980841758,127.0693334711
23241,선릉역,94,188,282,37.505447,127.051217
23242,삼성역,882,2402,3284,37.5074326917,127.0643204402
23243,강남경찰서.강남운전면허시험장,783,672,1455,37.5097985758,127.0670284926
23244,삼성역,2675,645,3320,37.5071289459,127.0636868176
23245,휘문고교사거리,462,1034,1496,37.504394,127.065214
23246,래미안하이스턴.대치순복음교회,1024,730,1754,37.4999449909,127.0638660962
23247,대치현대아파트,1184,1299,2483,37.5008238066,127.0600625549
23248,휘문중고등학교,990,880,1870,37.5039658555,127.0618980584
23249,휘문중고등학교,786,1539,2325,37.5040741974,127.0614966158
23250,대치사거리,783,769,1552,37.5036604676,127.0585776263
23251,무역센터.삼성역,1666,1268,2934,37.5078401374,127.0605488571
23252,한티역,1592,1293,2885,37.4981160997,127.0521475206
23253,도성초등학교,1156,974,2130,37.5001223629,127.0512135652
23254,도성초교사거리,276,442,718,37.5008208922,127.0519567662
23255,영동농협풍림아이원아파트,433,494,927,37.5021979661,127.0563510713
23256,영동농협풍림아이원아파트,391,300,691,37.5026183817,127.0568832362
23257,도성초교사거리,277,203,480,37.5008818613,127.0516118811
23258,진선여자중고등학교,994,1792,2786,37.5027442041,127.049965539
23259,선릉역,3775,2817,6592,37.5047611955,127.050462265
23260,포스코빌딩,940,3557,4497,37.5060493833,127.0548888307
23261,대치사거리,374,648,1022,37.503405,127.058292
23262,대치동현대아파트,1023,1165,2188,37.501646012,127.0591748622
23263,은마아파트입구사거리,2718,1771,4489,37.4987273789,127.0600675492
23264,도곡초등학교,848,904,1752,37.4976896078,127.0566485239
23265,한티역2번출구.서울강남고용노동지청,1368,1476,2844,37.4967735576,127.0539289896
23266,신논현역4번출구,539,186,725,37.504682,127.025813
23267,삼정호텔앞,71,235,306,37.5062420273,127.0311108359
23268,차병원,948,969,1917,37.50553234,127.0344860558
23269,차병원,837,1402,2239,37.5063571874,127.0345489808
23270,언주역5번출구.차병원사거리,321,330,651,37.5075577236,127.0353224874
23271,시티프라디움더강남.라움아트센터,239,870,1109,37.5078627567,127.0389267017
23272,라움아트센터.시티프라디움더강남,433,372,805,37.5077449631,127.0396488905
23273,아크로힐스논현,201,245,446,37.5091077534,127.0406479555
23274,선정릉역4번출구.시니어플라자,33,94,127,37.5098413413,127.0428920405
23275,선정릉역.국가무형유산전수교육관,1427,1061,2488,37.5092335728,127.0440935191
23276,선릉역,1136,1633,2769,37.5058843866,127.0481759639
23277,서울상록회관.한국기술센터,2126,1663,3789,37.503232,127.044057
23278,KT강남지사,1539,562,2101,37.5047549674,127.0419791463
23279,KT강남지사,474,1365,1839,37.5047578524,127.0414645036
23280,아가방빌딩.하나은행,1602,1644,3246,37.5016408218,127.0387713026
23281,역삼역7번출구.GS타워,2736,2544,5280,37.5015046036,127.036766173
23282,역삼역6번출구,1877,2404,4281,37.5015407612,127.0363873327
23283,역삼역4번출구,1717,1126,2843,37.500428516,127.0347356752
23284,강남역12번출구,1424,1878,3302,37.4988103664,127.0295583305
23285,강남역11번출구,1200,681,1881,37.499338,127.027257
23286,신논현역6번출구,1494,708,2202,37.502359976,127.0257902121
23287,강남역1번출구.역삼세무서,2095,2226,4321,37.4982974547,127.0290968277
23288,역삼역.포스코타워역삼,1142,2193,3335,37.4994895468,127.0335958701
23289,영동중앙교회,601,1067,1668,37.4981539451,127.0379751499
23290,강남구보건소,539,910,1449,37.515333228,127.042151467
23291,역삼럭키아파트.역삼월드메르디앙아파트,1583,1116,2699,37.491838771,127.0387194718
23292,역삼초등학교,399,224,623,37.4942184896,127.0341843565
23293,역삼초등학교,311,365,676,37.4943308436,127.0341054359
23294,뱅뱅사거리.역삼동,738,1202,1940,37.4902625053,127.033598088
23295,역삼초등학교,286,284,570,37.492195273,127.0306529668
23296,역삼2동주민센터.대림역삼아파트,796,516,1312,37.496245263,127.0459926766
23297,래미안그레이튼아파트,378,609,987,37.4960436368,127.0457084122
23298,역삼자이아파트,665,456,1121,37.499810373,127.044319709
23299,역삼동성당.역삼자이아파트,377,808,1185,37.4998793449,127.0437950854
23300,역삼동개나리아파트,802,581,1383,37.4993788675,127.0475961987
23301,역삼동개나리아파트,392,488,880,37.4994508516,127.0473484575
23302,총지사,474,1168,1642,37.4963226138,127.0404501731
23303,총지사,597,363,960,37.4966904984,127.0408425358
23304,영동중앙교회,894,631,1525,37.4977185179,127.03857548
23305,대한사회복지회,1092,2557,3649,37.501137,127.038818
23306,한국자산신탁.센터필드,1022,1453,2475,37.502783,127.044247
23307,진선여자중고등학교,1926,1037,2963,37.5022648571,127.0498724735
23308,역삼e-편한세상아파트,1325,1383,2708,37.4992545645,127.0512977977
23309,한티역,1243,990,2233,37.4972023372,127.0522475418
23310,한티역7번출구,3392,1040,4432,37.4960052231,127.0514784788
23311,역삼중학교.강남세브란스병원,1477,1469,2946,37.49471181,127.0476983171
23312,도곡1차아이파크.역삼청소년수련관,1769,1556,3325,37.4928082151,127.0417858592
23313,총지사,2116,410,2526,37.4949426926,127.0398633221
23314,도곡1동주민센터.역삼럭키아파트,1477,1570,3047,37.4915800523,127.0390292015
23315,도곡1차아이파크.도곡중학교,1137,1130,2267,37.4926349836,127.0424021052
23316,매봉삼성아파트SK리더스뷰,761,726,1487,37.4881449495,127.0489606775
23317,매봉역양재최의원,890,1203,2093,37.4861642605,127.0445616798
23318,양재역말죽거리.강남베드로병원,1498,1595,3093,37.4852510407,127.0379686178
23319,뱅뱅사거리.구영동중학교,1232,918,2150,37.4877243166,127.032807632
23320,고속철도수서역,117,59,176,37.4845010698,127.1037382748
23321,뱅뱅사거리뱅뱅프라자,1538,1116,2654,37.4897472768,127.0328763684
23322,원불교앞,558,93,651,37.4835581756,127.0423551365
23323,매봉역,2677,850,3527,37.4859166406,127.0448542288
23324,도곡개포한신아파트,320,577,897,37.4880373091,127.0493284024
23325,개포한신.우성4차아파트,256,418,674,37.4870851555,127.050372953
23326,우성캐릭터빌아파트,542,239,781,37.4870096821,127.0508009097
23327,군인공제회관,1140,640,1780,37.4892113897,127.0520250488
23329,숙명여고,651,503,1154,37.4897270653,127.0523674556
23330,도곡렉슬아파트.강남세브란스병원,1249,1496,2745,37.4944367753,127.0481867043
23331,한티역6번출구,384,1997,2381,37.495722,127.05194
23332,도곡렉슬아파트정문,445,419,864,37.4947508051,127.053435578
23333,중대부고앞,130,590,720,37.492538,127.054525
23334,구룡중학교앞,203,973,1176,37.485803,127.057243
23335,개포1동주민센터.개포고등학교,581,1288,1869,37.483066,127.059951
23336,개현초등학교,159,905,1064,37.481319,127.062072
23338,개포파크빌리지,669,385,1054,37.477328,127.057772
23339,별내상업지구,1023,335,1358,37.4809034856,127.0542007012
23340,현대아파트경남아파트,830,122,952,37.4828745638,127.0531173735
23341,현대1차.우성3차아파트,433,225,658,37.482973,127.056549
23342,개일초등학교앞,504,390,894,37.4861731624,127.0572119951
23343,개포고등학교,716,258,974,37.484213,127.058944
23344,개포1동주민센터,1284,428,1712,37.4825013593,127.0609693505
23345,래미안블레스티지아파트,2115,758,2873,37.480651,127.063217
23346,개포도서관,303,164,467,37.4836959018,127.0638958786
23347,수도전기공고후문,251,170,421,37.484782057,127.0656239958
23348,수도전기공고후문,98,224,322,37.485273,127.065984
23349,디에이치아너힐즈,287,842,1129,37.48373,127.068697
23350,개포자이프레지던스,1276,279,1555,37.483766,127.069256
23351,경기여고,685,1140,1825,37.48653,127.067244
23352,개포동역7번출구.개포시장,1311,1097,2408,37.4886501992,127.066161548
23353,개포주공5단지경기여고,1522,923,2445,37.4867075784,127.0674711689
23354,개포동역6번출구.개포시장,1147,1137,2284,37.4885440958,127.0665798221
23355,개포시장.개포5단지상가,115,238,353,37.4895230906,127.0680732652
23356,개포시장.개포5단지상가,248,78,326,37.489411,127.068631
23357,양전초등학교,73,167,240,37.490243,127.070593
23358,개포6단지앞,225,108,333,37.489962,127.07042
23359,디에이치자이개포아파트,592,1027,1619,37.4923003831,127.0755690336
23360,개원중학교.대모산입구역2번출구,386,1362,1748,37.492262,127.072156
23361,개포주공7단지앞,483,868,1351,37.4891592437,127.0738085758
23362,일원초등학교,1154,656,1810,37.488338773,127.0746897303
23363,현대아파트,31,698,729,37.4822653767,127.0528285196
23364,개포래미안포레스트,213,1070,1283,37.4799411421,127.0546102524
23365,능인선원앞,3,159,162,37.4725527152,127.0523679256
23366,구룡산입구,0,29,29,37.4772998668,127.0617734705
23367,능인선원앞,148,158,306,37.4720609789,127.0523276925
23368,구룡사입구,957,224,1181,37.4719206884,127.0507511248
23369,국악고교사거리,1706,484,2190,37.474526919,127.0480450265
23370,삼호물산,3156,429,3585,37.4772430549,127.0452517449
23371,구룡초등학교,242,150,392,37.480828,127.05311
23372,광수빌딩,196,301,497,37.4790607546,127.0493324033
23373,국민은행그린공원,555,247,802,37.4787698164,127.0468254619
23374,포이사거리삼호물산,659,179,838,37.478451,127.045145
23375,포이사거리삼호물산,292,929,1221,37.478296,127.045191
23376,국민은행그린공원,240,615,855,37.4785641982,127.0472425588
23377,광수빌딩,322,386,708,37.4789049887,127.0493780029
23378,개포지구대,198,245,443,37.4794240061,127.0512016967
23379,구룡초등학교,416,340,756,37.480467,127.052903
23380,수서삼성아파트앞,731,507,1238,37.4843993977,127.0909893034
23381,일원본동주민센터,1081,1492,2573,37.4834885153,127.0847497652
23382,푸른마을아파트앞,1081,530,1611,37.4829129209,127.0805834065
23383,상록수아파트앞,176,356,532,37.4828046299,127.0821222482
23384,일원본동주민센터,740,598,1338,37.4833831017,127.0859753943
23385,수서119안전센터앞,615,608,1223,37.4842412879,127.0938503097
23386,삼성서울병원정문,207,361,568,37.4865445092,127.0829902821
23387,삼성서울병원정문건너편,218,138,356,37.4870251768,127.0824491516
23388,일원역7번출구,178,178,356,37.484911433,127.0833076652
23389,삼성서울병원후문,1253,508,1761,37.4901997236,127.0875200547
23392,삼성서울병원사거리,316,243,559,37.4891174907,127.0824473261
23393,강남한양수자인아파트,297,183,480,37.4781574286,127.1133506298
23394,강남한양수자인아파트,208,350,558,37.477818,127.113478
23395,대치아파트.대모산입구역3번출구,1726,672,2398,37.4924140029,127.0724873208
23397,대청역,197,233,430,37.4932399657,127.0786043309
23398,마루공원,19,97,116,37.4948202584,127.0833130163
23399,대청초등학교,4,200,204,37.493870617,127.0865721019
23400,서울일원동우체국,589,691,1280,37.4919969862,127.0876266147
23401,수서역현대벤쳐빌,130,210,340,37.4876807848,127.1021201028
23402,수서역,945,270,1215,37.4883076816,127.1007452609
23403,수서역KT수서지점,73,589,662,37.4885476793,127.0998654903
23404,수서역1번출구,2135,2762,4897,37.4871885183,127.1007358421
23405,세곡동주민센터,90,33,123,37.4696395193,127.1080981819
23406,궁마을,280,330,610,37.4854278045,127.0973286229
23407,궁마을,365,487,852,37.4852808034,127.0976066393
23408,수서역,8791,2197,10988,37.4867911067,127.1020425697
23409,수서역5번출구,397,1780,2177,37.4868602717,127.1025969044
23410,수서역.로즈데일빌딩,3033,1293,4326,37.4873984409,127.1028677279
23411,세곡동주민센터,34,156,190,37.469461957,127.1076740129
23412,은곡마을.LH이편한세상,798,470,1268,37.4653476974,127.1025352444
23413,강남신동아파밀리에1단지,46,522,568,37.4654339318,127.0999208093
23414,대왕초등학교,101,100,201,37.4646708281,127.1068384861
23416,세곡동,9,42,51,37.4646105826,127.1095067201
23417,광연자동차학원앞,36,86,122,37.4656909003,127.1163609853
23418,삼일자동차학원.강남자동차검사소,121,169,290,37.4679153957,127.1211804938
23419,삼일자동차학원.강남자동차검사소,214,104,318,37.4679987199,127.1207679842
23420,광연자동차학원앞,54,28,82,37.4670229687,127.1188445352
23421,세곡동,75,172,247,37.4649373007,127.1093969858
23422,세곡동사거리,151,42,193,37.465796284,127.108561756
23423,방죽마을,488,111,599,37.4723837769,127.107350365
23424,래미안포레아파트,1098,136,1234,37.4745489674,127.1067825531
23425,쟁골마을,65,406,471,37.4818869624,127.1050772751
23426,쟁골마을,128,419,547,37.4826545844,127.1043990475
23427,래미안포레아파트,174,1079,1253,37.4751350942,127.1062605211
23428,방죽마을,97,424,521,37.4722247345,127.106920465
23429,압구정역3번출구,1348,1706,3054,37.5260014748,127.0287139855
23430,국민은행압구정종합금융센터,938,1815,2753,37.523272893,127.0285130905
23431,언주역2번출구.차병원사거리,1144,1330,2474,37.5079530218,127.0333616903
23432,영동고교앞,764,1851,2615,37.5215035461,127.0398932882
23433,개포우성6차아파트,119,66,185,37.4757363339,127.0578803329
23434,은곡마을진입로,217,38,255,37.4657576277,127.0987019628
23435,대치유수지체육공원,314,634,948,37.501358,127.068123
23436,우성아파트,769,554,1323,37.501143627,127.0684146056
23437,세곡푸르지오.은곡삼거리,244,69,313,37.4649702658,127.0946994252
23438,삼성역3번출구,1834,939,2773,37.5071627199,127.0637122939
23439,세곡푸르지오.은곡삼거리,40,215,255,37.465062,127.096478
23440,LH수서아파트,1194,102,1296,37.479078,127.105708
23441,LH수서아파트,79,1023,1102,37.4786070506,127.1053468464
23442,세곡2지구3.4단지,628,242,870,37.4769291284,127.1100617023
23444,역삼1동주민센터,87,89,176,37.496548,127.032341
23445,개포우성아파트,43,291,334,37.4765644257,127.0578638641
23446,래미안강남힐즈,1147,443,1590,37.4723483229,127.0973806587
23447,세곡중학교.세명초등학교,661,1401,2062,37.4702479734,127.0917980067
23448,세곡중학교.세명초등학교,1480,632,2112,37.4704122141,127.0920469065
23449,일원동한솔아파트,572,955,1527,37.4825445295,127.0793139035
23450,시립수서청소년센터,378,374,752,37.483863,127.089107
23453,포스코사거리,326,1034,1360,37.5080791101,127.055736576
23454,대왕초등학교,238,78,316,37.4650705422,127.1065571269
23456,도곡역4번출구,2881,834,3715,37.4899733606,127.0556100386
23457,개포중학교,353,1360,1713,37.480019,127.063631
23458,구룡마을,197,10,207,37.478975,127.064041
23459,디에이치퍼스티어아이파크,1017,264,1281,37.478381,127.056741
23462,영희초등학교,193,205,398,37.4911914327,127.0804871277
23463,못골마을.강남자곡아이파크,650,1278,1928,37.4732649886,127.1017217712
23464,못골마을,1465,377,1842,37.4731023528,127.1018882443
23465,태화기독교사회복지관,580,635,1215,37.4845282141,127.0933527923
23466,개포도서관,51,345,396,37.483553,127.063564
23467,강남세곡체육공원,4,60,64,37.465565,127.112862
23468,도곡교회.인바디빌딩,128,155,283,37.4744335616,127.0554585033
23469,강남세브란스병원,344,340,684,37.4933489347,127.0474623305
23470,도곡교회.인바디빌딩건너,49,79,128,37.4742753543,127.0559940835
23471,래미안강남힐즈,447,1289,1736,37.4722905356,127.0952484632
23472,도곡중학교.강남세브란스병원,345,469,814,37.4936020408,127.0467216289
23473,강남경찰서.강남운전면허시험장,1081,1064,2145,37.5095036021,127.0660087348
23474,수도공고앞,80,21,101,37.487234,127.061926
23475,개포4단지5단지,10,68,78,37.486365,127.068309
23476,개포4단지6단지,0,38,38,37.4868514825,127.072073511
23477,개포4단지7단지,0,144,144,37.487918251,127.0735755585
23478,마루공원,107,33,140,37.49485,127.082818
23479,개포동역1번출구,19,69,88,37.488967804,127.0654139271
23480,세곡푸르지오,216,530,746,37.4675388365,127.093835078
23481,경남아파트,132,312,444,37.4889759836,127.0413200765
23482,강남효성해링턴코트,691,423,1114,37.4676884285,127.0939126611
23483,구룡역5번출구,6,110,116,37.4861062927,127.0591999287
23484,구룡역1번출구,105,35,140,37.4861696665,127.058961369
23488,럭키아파트,339,559,898,37.4916371451,127.0411232813
23489,래미안개포루체하임아파트,254,158,412,37.4893028717,127.0814750981
23491,수도공고,17,65,82,37.48755,127.062351
23492,개포4단지6단지,5,1,6,37.4869928876,127.0719670062
23493,개포4단지5단지,11,6,17,37.486497,127.068237
23500,학여울역,47,108,155,37.497144,127.071451
23501,학여울역,82,38,120,37.4966786872,127.0713978002
23504,도곡한신아파트,73,317,390,37.4868758329,127.0411576487
23505,현대1차아파트,97,320,417,37.482287,127.05525
23507,영동고등학교현대아파트,2637,1268,3905,37.5213549869,127.0395300499
23508,개포4단지7단지,100,0,100,37.4876526608,127.0729326014
23509,총회회관.휘문고입구,316,808,1124,37.504156,127.066098
23510,예림당아트홀.신한은행전산센터,570,764,1334,37.498222358,127.0442961535
23511,새마을운동중앙회,1143,617,1760,37.5018921366,127.0672391271
23512,총지사,237,847,1084,37.4947101031,127.0395898829
23513,신한은행데이터센터,617,385,1002,37.4981459957,127.0436967482
23514,포스코사거리,123,114,237,37.5073192617,127.0575278976
23515,우성3차아파트,344,311,655,37.4838187251,127.0571827363
23516,우성6차아파트,275,485,760,37.4775486459,127.0551994825
23517,포이초교,298,258,556,37.4752206839,127.0526851839
23518,국악중고교,404,201,605,37.4756518082,127.0506448815
23519,풍양빌딩,248,95,343,37.4773892734,127.0488173808
23520,코원에너지서비스,45,50,95,37.4980697598,127.0760972384
23521,코원에너지서비스,26,75,101,37.4984896319,127.076162131
23523,포스코사거리교차로,172,579,751,37.5070321739,127.0579066873
23524,국민은행그린공원,121,90,211,37.4787861872,127.0479647043
23525,삼익아파트앞,316,160,476,37.4898912383,127.041707484
23526,래미안포레아파트,373,889,1262,37.4756585108,127.1072950785
23527,디아크리온강남아파트,355,238,593,37.4760978962,127.1076846516
23528,세곡2지구3.4단지,283,702,985,37.476668,127.110393
23529,도곡한신아파트,182,54,236,37.4865461779,127.0414335753
23530,강남더샵라르고오피스텔,451,1210,1661,37.4752274507,127.1048166174
23531,한남대교전망카페,726,809,1535,37.5245524646,127.0156821849
23532,서울의료원후문,9,4,13,37.512854221,127.0670297734
23533,구룡마을,28,48,76,37.477288604,127.061773461
23536,학동역,13,54,67,37.5153752342,127.0299918634
23537,은곡마을.강남신동아파밀리에,1190,792,1982,37.465026,127.102457
23538,강남현대힐스테이트에코,1154,269,1423,37.4750109081,127.1049627778
23543,대왕초등학교,211,37,248,37.4647336817,127.1060868044
23544,수서역5번출구.이마트앞,820,2875,3695,37.4867890817,127.1026711271
23545,개포4복합문화센터.달터공원,235,38,273,37.4765501377,127.0496563833
23546,일원역,790,36,826,37.4842740914,127.0837487838
23552,삼성서울병원정문,36,48,84,37.486220916,127.0831278825
23557,국민은행,118,19,137,37.4783965969,127.0477270355
23558,삼성서울병원본관,314,402,716,37.4880871291,127.0843625606
23562,한아름아파트.사이룩스오피스텔,191,102,293,37.4882883158,127.1043695699
23564,암센터후문.장례식장,165,243,408,37.489906166,127.0877033472
23569,암센터정문,250,76,326,37.4887280795,127.0877105812
23572,신분당선.강남역4번출구,821,618,1439,37.4945395934,127.0295651284
23573,영동2교,147,155,302,37.4824106082,127.0436209282
23575,강남서초교육지원청,92,60,152,37.5114525879,127.0474431396
23579,래미안루체하임.일원동맛의거리,138,60,198,37.4895038011,127.0816026028
23586,영희초등학교,206,301,507,37.4913516516,127.080747403
23595,개포동역8번출구,23,41,64,37.488672,127.064961
23597,강남우체국,458,346,804,37.493332,127.07827
23598,도성초등학교앞,133,138,271,37.5004642646,127.0503202915
23600,개포3일원1동통합주민센터,544,282,826,37.4923887632,127.0753812691
23629,LH이편한세상,185,8,193,37.4674060713,127.1018353507
23641,신논현역,268,1,269,37.5007572469,127.0265819837
23697,동영문화센터,153,218,371,37.4980171807,127.0448218851
23698,도곡2동주민센터.대치중학교,69,248,317,37.4842540701,127.0454044309
23720,도곡2동주민센터대치중학교,190,141,331,37.484486108,127.0453310783
23728,대청역,741,307,1048,37.4932933255,127.0796503721
23731,영동2교,72,168,240,37.4827748285,127.0436397429
23738,강남세브란스병원,98,162,260,37.4941024226,127.0460354686
23741,삼성역,45,1226,1271,37.5074664994,127.0642837114
23749,매봉역입구,67,1873,1940,37.485055,127.046452
23756,역삼청소년수련관.도곡1차아이파크,83,156,239,37.4931043457,127.0427156329
23815,영희초등학교정문,103,177,280,37.4917702392,127.0826658438
23818,코엑스동문,765,341,1106,37.5122075875,127.0608775706
23819,일원지구대,88,172,260,37.4925024781,127.0844466897
23822,대청초교삼거리,184,79,263,37.4933069756,127.0862704324
23823,대청초교삼거리,93,174,267,37.4931669875,127.0863914747
23849,한남대교,32,5,37,37.528853029,127.010968261
23850,한남대교,0,37,37,37.5292208753,127.0113976166
23855,노블발렌티웨딩홀,135,59,194,37.5151343457,127.0648043953
23856,양재전화국,71,162,233,37.485645559,127.0407892731
23857,대치2동주민센터.래미안하이스턴,315,635,950,37.501732,127.066677
23858,봉은사역.삼성래미안아파트,81,3,84,37.5147161467,127.062290678
23863,강남구민체육관,315,284,599,37.47599,127.053878
23866,LPG가스충전소,205,520,725,37.490756,127.035844
23871,수서역,31,325,356,37.4887031579,127.0998006806
23872,서울일원동우체국,981,507,1488,37.492279,127.087654
23874,일원지구대,233,74,307,37.4925603569,127.0841549821
23876,동영문화센터,160,132,292,37.4982163309,127.0450698684
23877,영희초등학교,97,73,170,37.4918172767,127.0824080525
23878,삼성서울병원정문건너편,2,93,95,37.4864455837,127.0827108625
23880,일원역,39,119,158,37.484028248,127.0835865217
23883,강남더드림병원.도성초등학교,41,218,259,37.5010137322,127.050799086
23884,대왕파출소,42,426,468,37.465202563,127.1077413737
23893,강남신동아파밀리에2단지,28,23,51,37.4646017803,127.101712859
23896,한신휴플러스6단지,159,10,169,37.4689755358,127.1039561716
23911,중동고등학교,165,759,924,37.4928867094,127.0800445003
23917,영희초등학교후문,57,109,166,37.4915200321,127.0804796035
23918,양재역4번출구,2075,2632,4707,37.4850648693,127.0368399956
23920,양재역.종합복지관,3000,1318,4318,37.4847100069,127.0361954353
23921,양재역5번출구,1119,288,1407,37.484670255,127.0366159066
23922,삼성역7번출구,32,200,232,37.5101870003,127.0628058221
23923,삼성역7번출구,124,169,293,37.5102994898,127.0627364693
23924,도곡중학교.강남세브란스병원,49,97,146,37.493474,127.044794
23925,역삼2동주민센터.래미안그레이튼아파트,93,67,160,37.4948269156,127.0466349415
23933,방죽마을입구,9,13,22,37.4712200208,127.1064669403
23937,방죽마을입구,3,72,75,37.471284,127.106377
23938,한신휴플러스6단지,3,137,140,37.469051,127.103892
23940,LH이편한세상,5,139,144,37.467521028,127.1017450741
23941,은곡마을,141,175,316,37.4669861388,127.0976381775
23942,상업지역,692,263,955,37.4669833895,127.1009106768
23943,강남신동아파밀리에,221,138,359,37.4654986324,127.1013099646
23944,세종고등학교,37,44,81,37.4878639673,127.1029015023
23946,세곡푸르지오,74,61,135,37.4668377495,127.0945265693
23947,세곡푸르지오,13,63,76,37.4667838109,127.094373898
23948,상업지역,9,161,170,37.4671769696,127.0999592175
23949,은곡마을,3,44,47,37.4672323203,127.0967995753
23950,강남스포츠문화센터,18,89,107,37.4885775772,127.1050565277
23958,리엔파크3단지,2,181,183,37.4630389394,127.1038273014
23960,포스코사거리,24,386,410,37.5086692856,127.0555079747
23961,서울요양원.강남구립행복요양병원,4,137,141,37.4607011121,127.1034878036
23962,LH이편한세상,4,334,338,37.4666325065,127.1018278599
23963,강남데시앙포레정문,280,289,569,37.4814068182,127.0890614341
23964,강남데시앙포레상가앞,261,2,263,37.4813620057,127.0918528925
23965,강남더샵포레스트아파트,127,17,144,37.4821279592,127.0944327655
23967,강남신동아파밀리에1단지,109,22,131,37.4633952819,127.1013912358
23968,강남더샵포레스트아파트,3,176,179,37.4820890986,127.0942667912
23969,강남데시앙포레상가앞,0,248,248,37.4814270894,127.0927451217
23970,강남데시앙포레정문,0,85,85,37.4818476385,127.0895874825
23971,수서교회.수서동성당앞,118,101,219,37.4834861241,127.0945644992
23972,수서교회.수서동성당앞,37,36,73,37.4834702749,127.0946662374
23981,삼성서울병원사거리,393,514,907,37.4888402553,127.0826986083
23983,한남대교,1,0,1,37.5236500935,127.0156592131
23993,강남신동아파밀리에2단지,61,143,204,37.4634710379,127.1022596955
23994,일원주유소.삼성서울병원후문,793,1103,1896,37.4906537597,127.0876822994
23995,리엔파크4단지.강남데시앙파크,608,465,1073,37.4612273528,127.1018750091
24001,잠실역.잠실대교남단,883,466,1349,37.5155383911,127.0985638839
24002,잠실역.잠실대교남단,2789,3103,5892,37.5137872849,127.0996446129
24003,석촌호수.한솔병원,2768,2547,5315,37.5068001738,127.1058262006
24004,석촌호수.한솔병원,2337,2934,5271,37.507105259,127.1052520216
24005,석촌역,2185,2400,4585,37.5034082968,127.1089442853
24006,석촌역,2127,1640,3767,37.5036628588,127.108453771
24007,송파역,2464,1812,4276,37.5002084826,127.1118384337
24008,송파역,1631,1963,3594,37.5005992316,127.111232788
24009,가락시장.가락시장역,3147,2018,5165,37.4943822012,127.1171609467
24010,가락시장.가락시장역,2063,2409,4472,37.4949314726,127.116483446
24011,문정로데오거리입구,2235,908,3143,37.488212078,127.1214160323
24012,문정로데오거리입구,702,2126,2828,37.489139823,127.12082328
24013,문정법조단지.건영아파트,2878,830,3708,37.482125,127.124748
24014,문정법조단지.건영아파트,927,2517,3444,37.48309,127.123873
24015,장지역.가든파이브,1834,597,2431,37.4790394341,127.1261444661
24016,장지역.가든파이브,2426,1891,4317,37.479907,127.125472
24017,잠실역.롯데월드몰,2074,3967,6041,37.5127165509,127.1005791644
24101,천호역.풍납시장,3561,1362,4923,37.5370408432,127.122573363
24102,풍납1치안센터입구,92,154,246,37.5342780446,127.1215873404
24103,파크데일아파트2단지앞,300,512,812,37.4979450637,127.1584215427
24104,파크데일아파트1단지앞,515,27,542,37.4981356955,127.1584260863
24105,풍납1동동아한가람아파트,355,252,607,37.5370174691,127.1144409964
24106,풍납동신성노바빌,204,99,303,37.538146277,127.1158760068
24107,풍납동씨티극동아파트,192,299,491,37.5392876113,127.1171232654
24108,풍납토성.천호역10번출구,580,1910,2490,37.5389358276,127.1219626352
24109,영파여고.강동구청역,1166,1250,2416,37.5312540389,127.1205104608
24110,풍납동극동.쌍용아파트,1143,669,1812,37.5265632485,127.1180236157
24111,풍납중학교,256,121,377,37.5246379417,127.1149375554
24112,풍성중학교.잠실올림픽아이파크,79,137,216,37.5248109306,127.1135650154
24113,울산대학교의과대학,374,469,843,37.5248334207,127.1099764895
24114,서울아산병원동관,741,1011,1752,37.5268880703,127.1071794656
24115,서울아산병원동관,954,783,1737,37.5270255668,127.1075881058
24116,풍납토성서성벽,123,231,354,37.5314550714,127.1107357443
24117,송파두산위브.송파소방서,453,90,543,37.5001266228,127.1416513795
24118,송파두산위브.송파소방서,49,358,407,37.5000316637,127.1418761558
24119,토성초등학교.현대리버빌아파트,169,253,422,37.5300706557,127.114543517
24120,풍납동영어체험마을,278,166,444,37.5311067795,127.112225803
24121,올림픽대교남단,341,147,488,37.5267442285,127.115430691
24122,마천역.송파파크센트럴,379,169,548,37.494369,127.151301
24123,잠실파크리오아파트상가.올림픽회관,1107,762,1869,37.521023915,127.1146491783
24124,잠실파크리오아파트앞,359,382,741,37.5196076645,127.1099150878
24125,잠실나루역,183,865,1048,37.5188856733,127.1058907813
24126,잠실진주아파트,244,279,523,37.5195809296,127.1114625427
24127,몽촌토성역,96,249,345,37.5183703702,127.1130098586
24128,신천동진주아파트,562,1118,1680,37.516633,127.109278
24129,잠실나루역,682,284,966,37.5182652128,127.104432803
24130,잠실중학교.장미종합상가,930,1101,2031,37.51715,127.10066
24131,잠실중학교,973,684,1657,37.516785,127.100445
24132,잠실역8번출구,1785,6116,7901,37.514013177,127.1015366899
24133,잠실역7번출구,3200,1652,4852,37.5146065479,127.099443484
24134,잠실역1번.11번출구,5166,1830,6996,37.5140635066,127.1032419033
24135,잠실역9번출구,660,1164,1824,37.5149140996,127.1042158389
24136,송파구청.방이맛골,1623,934,2557,37.5139968944,127.1072176522
24137,잠실역6번출구,47,444,491,37.5143926246,127.0988017918
24138,잠실역.롯데월드,3465,4718,8183,37.5129509238,127.0977630619
24139,잠실5단지,1006,1001,2007,37.5122132454,127.0939144028
24140,잠실리센츠아파트앞,139,208,347,37.5119152103,127.0913235945
24141,잠실새내역.잠실2동주민센터,593,2252,2845,37.5117722886,127.0872805398
24142,잠실엘스아파트앞,1756,1978,3734,37.5118706155,127.0833904794
24143,종합운동장사거리,1219,1158,2377,37.5120589943,127.0796844479
24144,잠실종합운동장,1375,2007,3382,37.5111175337,127.0720732937
24145,잠실트리지움아파트앞,1093,1109,2202,37.5115214003,127.091102025
24146,잠실역.롯데월드,6767,3209,9976,37.51241161,127.0981962498
24147,갤러리아팰리스,431,609,1040,37.511317434,127.0929234933
24148,잠실트리지움,295,337,632,37.5109779513,127.0926278344
24149,영동일고레이크팰리스앞,676,333,1009,37.5088084767,127.0921466781
24150,영동일고.트리지움동문앞,276,500,776,37.509037,127.091732
24151,송파레이크힐아파트,87,75,162,37.485173,127.143618
24152,잠실학원사거리.잠실트리지움남문,680,624,1304,37.5076826578,127.0902574376
24153,잠실119안전센터,797,274,1071,37.5070078199,127.0947494345
24154,잠실종합운동장,4507,2091,6598,37.510665,127.073172
24155,아시아선수촌아파트,804,668,1472,37.5104100042,127.0784474662
24156,아주중학교,500,521,1021,37.5047809208,127.0765948239
24157,종합운동장사거리,2148,2070,4218,37.5116128425,127.0795554593
24158,잠실새내역4번출구,3976,1934,5910,37.5114453148,127.0843635917
24159,영빌딩앞,188,457,645,37.506535,127.089623
24160,잠실우성4차현대아파트,788,667,1455,37.5052624454,127.0852075828
24161,잠실우성4차현대아파트,692,791,1483,37.5049573596,127.0853685093
24162,잠실근린공원.성현교회,1162,746,1908,37.506274,127.081873
24163,아시아선수촌아파트삼거리.성현교회,1003,1371,2374,37.5061948176,127.0809929896
24164,아시아선수촌아파트,331,1032,1363,37.5098569453,127.079036654
24165,아주중학교,660,518,1178,37.5053703912,127.0779320598
24166,삼전역,1531,1780,3311,37.5039320658,127.0889637793
24167,삼전역,1248,1094,2342,37.5039542558,127.0897903395
24168,송파구민회관구의회,1116,1141,2257,37.5027059543,127.0947575704
24169,송파구민회관구의회,1323,1240,2563,37.5024275447,127.0945601098
24170,삼학사길사거리,192,360,552,37.5046915991,127.0969945434
24171,잠실119안전센터,385,779,1164,37.5070038465,127.0929452929
24172,삼전삼밭나루공원입구,647,161,808,37.5062807775,127.0898346017
24173,삼전역.잠실현대아파트,378,502,880,37.5034263635,127.0874731559
24174,삼전동현대APT,192,94,286,37.5004306288,127.0874664895
24175,삼전동쌍용하이츠빌라,428,289,717,37.4992253627,127.0908500813
24176,삼전사회복지관,240,279,519,37.498093007,127.0942398906
24177,배명중고교,988,654,1642,37.5001551941,127.0966612411
24178,석촌고분역,544,851,1395,37.5026705428,127.0983927355
24179,석촌고분역,809,641,1450,37.5024287111,127.0986427773
24180,석촌역.잠실한솔아파트,1132,1030,2162,37.5045154646,127.1052845803
24181,석촌역.잠실한솔아파트,822,943,1765,37.504393607,127.1056431899
24182,송파레이크파크호반써밋2차정문,61,111,172,37.48504,127.143358
24183,삼학사길사거리,325,226,551,37.5040381549,127.0972566454
24184,배명중고교,440,531,971,37.4997098452,127.0969106203
24185,석촌동남현교회앞,457,339,796,37.49902004,127.1006951845
24186,석촌동남현교회앞,362,493,855,37.4988052989,127.1002693019
24187,송파책박물관.헬리오시티,580,483,1063,37.5002341376,127.1044857249
24188,송파책박물관.헬리오시티,687,590,1277,37.4999173582,127.1040226991
24189,송파사거리.석촌시장,356,552,908,37.5015446024,127.1091779641
24190,송파사거리,414,428,842,37.5016111846,127.1087521268
24191,송파역.헬리오시티,497,551,1048,37.5005814149,127.1110144742
24192,위례포레샤인13단지공원,6,76,82,37.4831525877,127.1362423559
24193,송파여성문화회관,355,428,783,37.5069356421,127.1094493659
24194,송파여성문화회관,525,394,919,37.5067280867,127.1096247621
24195,송파초등학교.송파동성당,465,395,860,37.5091624679,127.111297551
24196,송파초등학교.송파동성당,246,371,617,37.5087366131,127.111379311
24197,방이사거리,457,816,1273,37.5106676569,127.1107862085
24198,포레나송파후문,289,142,431,37.484588,127.146938
24199,송파나루역,845,751,1596,37.5095628649,127.1132143042
24200,한양공원,722,251,973,37.5038731127,127.1138832242
24201,송파동한양1차아파트,823,409,1232,37.5059567152,127.1154171073
24202,서울방이동고분군,436,1061,1497,37.5084245055,127.1151707999
24203,송파역,272,462,734,37.4992928463,127.1129081285
24204,성지아파트,315,348,663,37.4997831426,127.1174306486
24205,송파동삼익아파트,68,186,254,37.5029232975,127.1219127896
24206,송파미성.가락삼익아파트,1411,1407,2818,37.5060869823,127.1203825294
24207,송파한양2차아파트,346,606,952,37.5059979239,127.1157233661
24208,한양공원,193,644,837,37.503707,127.113797
24209,잠실여고후문,321,585,906,37.5025722156,127.112010612
24210,방이중학교,396,405,801,37.5141640145,127.114367187
24211,한성백제역4번출구,260,203,463,37.514991586,127.1153631525
24212,송파나루역.방이시장,418,471,889,37.5110032307,127.1124463657
24213,송파나루역.방이시장,408,309,717,37.5110903245,127.1129451561
24214,송파나루역,929,759,1688,37.5106794362,127.1116741986
24215,송파구청.방이맛골,1351,2590,3941,37.5133521526,127.1077935895
24216,잠실진주아파트,907,805,1712,37.5161753691,127.1096189729
24217,올림픽베어스타운아파트앞,248,338,586,37.5148280531,127.1191035641
24218,방이초등학교,528,164,692,37.5118704957,127.1191093326
24219,방이시장입구,519,63,582,37.5101122511,127.1180475372
24220,방이우체국,712,637,1349,37.5095130652,127.1139245961
24221,올림픽공원남2문,332,486,818,37.5140240154,127.1214072807
24222,올림픽공원장미광장,221,335,556,37.512651295,127.1249201549
24223,방이역3번출구대림아파트,429,197,626,37.5084180897,127.1256144074
24224,잠실3차한양아파트,1584,979,2563,37.5059143549,127.1217137999
24225,방이시장입구,143,565,708,37.5098959398,127.1181178868
24226,방이초등학교,110,260,370,37.5120164557,127.1194587268
24227,신구블레스밸리앞,114,265,379,37.5114130601,127.1214991808
24228,신구블레스밸리,402,121,523,37.511617539,127.1218814103
24229,방이동대림코오롱아파트,87,446,533,37.5091863822,127.1242379509
24230,방이동대림코오롱아파트,492,94,586,37.509558775,127.1240112053
24231,올림픽회관,901,876,1777,37.5209125924,127.1151501871
24232,풍납동극동.쌍용아파트,845,1547,2392,37.5268432202,127.1186989404
24233,한성백제박물관,195,204,399,37.5155282741,127.1193031384
24234,서울체육중.고등학교,26,45,71,37.5222031515,127.1313779815
24235,둔촌오륜역.서문교회,131,279,410,37.5184657678,127.1397435665
24236,서하남IC입구,26,95,121,37.5171037198,127.142813844
24237,효죽동입구,55,96,151,37.5124681797,127.1418482902
24238,포레나송파정문,210,437,647,37.4871132362,127.1481048785
24239,올림픽공원장미광장,296,280,576,37.5128834629,127.1261589886
24240,올림픽공원남2문,163,202,365,37.5146224597,127.1218099465
24241,몽촌토성역.한성백제역,245,396,641,37.5171997563,127.1146313009
24242,보성중고등학교,118,459,577,37.5200225221,127.1335690395
24243,보성중고등학교,439,615,1054,37.5197348402,127.1330029301
24244,올림픽공원역,1254,1618,2872,37.5167177922,127.1308988886
24245,올림픽공원역,1783,1030,2813,37.516324269,127.1314785378
24246,올림픽공원테니스장,37,75,112,37.5132952952,127.1285971938
24247,올림픽선수촌아파트,596,720,1316,37.5133215257,127.1293296238
24248,방이역,458,665,1123,37.5088511089,127.1264971658
24249,오금역.오금동현대아파트,2261,2196,4457,37.5032944565,127.1264326302
24250,오금공원앞,681,703,1384,37.4992235146,127.1329750231
24251,개롱역.오금동상아아파트,956,814,1770,37.497653816,127.1359380431
24252,보인고교.오금동삼성아파트,890,1168,2058,37.4964468948,127.138225687
24253,송파사회복지관.성요셉성당,320,79,399,37.4980789633,127.1407036537
24254,거여초등학교,1017,210,1227,37.502548108,127.1402155083
24255,거여초등학교,282,1008,1290,37.50241,127.140012
24256,송파참병원,32,129,161,37.5036199871,127.1375165211
24257,송파참병원,102,194,296,37.5038625052,127.1374117762
24258,신흥운수입구,257,195,452,37.5043505304,127.1353925625
24259,신흥운수입구,546,100,646,37.5050336659,127.1341530556
24260,송파레미니스후문,0,250,250,37.5061531582,127.1354499522
24261,송파레미니스후문,640,18,658,37.506195,127.135317
24262,오금공원사거리,146,409,555,37.506034168,127.1310600773
24263,오금공원사거리,323,230,553,37.5063791494,127.1310586523
24264,오금동대림아파트,587,289,876,37.5079159405,127.1279923625
24265,오금동대림아파트,507,762,1269,37.5076510292,127.1281153138
24266,송파도서관,611,208,819,37.500556,127.136481
24267,우창아파트,354,643,997,37.4997505359,127.1360639933
24268,오금동사거리,498,153,651,37.5027436793,127.1378915552
24269,오금동사거리,34,434,468,37.502775,127.138162
24270,거여역1번출구,996,298,1294,37.4940540879,127.1426661724
24271,거여역8번출구.현대1차아파트,295,921,1216,37.4938176621,127.1424783113
24272,송파체육문화회관.서울인공지능고,266,568,834,37.4908038511,127.1433758342
24273,거여역2번출구,171,270,441,37.4943119554,127.1447634037
24274,송파사회복지관.성요셉성당,82,416,498,37.498118,127.140953
24275,송파체육문화회관.거여아파트단지,669,719,1388,37.4904638928,127.1435753484
24276,거여역5번출구,992,500,1492,37.492903745,127.145676706
24277,거여역4번출구,415,470,885,37.4931392222,127.1456917976
24278,송파파크센트럴,290,358,648,37.492941,127.148924
24279,거여삼거리,174,211,385,37.492768,127.152763
24280,비호아파트,89,204,293,37.4920054572,127.1541840407
24281,인애가요양병원,0,466,466,37.505185,127.134924
24282,마천1동주민센터.송파롯데캐슬,58,272,330,37.4957685389,127.1496062555
24283,마천2동주민센터.송파롯데캐슬,160,538,698,37.4967388534,127.1482313861
24284,거여역3번출구.현대2차아파트,323,360,683,37.4942807491,127.1450941869
24285,마천1동주민센터,362,108,470,37.495710391,127.1498825172
24286,마천역.송파파크센트럴,173,474,647,37.4934555292,127.1522337071
24287,비호아파트,148,337,485,37.492178,127.15409
24288,남한산성입구,189,165,354,37.490972,127.157155
24289,송파구립마천청소년센터,48,229,277,37.491982,127.156552
24290,송파구립마천청소년센터,267,100,367,37.4918330886,127.1567901158
24291,송파보훈회관.금호어울림2차,540,134,674,37.4939681019,127.1558084636
24292,송파보훈회관.금호어울림2차,124,505,629,37.493992,127.155567
24293,마천동금호어울림1차아파트,534,130,664,37.4971997434,127.1541947193
24294,마천동금호어울림1차아파트,143,531,674,37.497978,127.154075
24295,마천시장마천동우방아파트앞,300,966,1266,37.499937,127.15151
24296,남천초교마천동우방아파트앞,1229,186,1415,37.4999186245,127.1519312753
24297,청암노인요양원,84,534,618,37.501352,127.148553
24298,청암노인요양원,283,54,337,37.5010794011,127.150052252
24299,마천사거리,1293,301,1594,37.4985293494,127.1466290856
24300,마천사거리,299,1151,1450,37.49872,127.1471
24301,마천2동윤진빌딩.신동아아파트,524,1408,1932,37.4996357865,127.1440592408
24302,마천2동윤진빌딩.신동아아파트,1888,421,2309,37.4996759516,127.1442444466
24303,마천2동주민센터,508,120,628,37.4970139451,127.1480088453
24304,성내천공원,243,142,385,37.50072,127.147632
24305,복정역1번출구,79,151,230,37.4723236592,127.1271368118
24306,거여1동주민센터,127,229,356,37.4963456501,127.1456268495
24307,건영아파트,143,63,206,37.481675,127.126677
24308,문현중학교,52,355,407,37.479987,127.12675
24309,문현중학교,515,67,582,37.4800743082,127.1269147543
24310,문덕초등학교.문정고등학교,431,141,572,37.483681076,127.126405225
24311,문정푸르지오1차아파트,135,149,284,37.486465,127.12834
24312,힐스테이트e편한세상문정,352,543,895,37.488923933,127.1319278009
24313,문정시영가락프라자아파트,366,318,684,37.4912230266,127.1345693493
24314,문정시영.세양청마루아파트,317,374,691,37.492386841,127.1359635544
24315,한림연예예술고교,261,92,353,37.4853687826,127.1314174837
24316,한림연예예술고교,86,289,375,37.485403,127.131745
24317,문현초등학교,99,223,322,37.482985,127.128678
24318,문현초등학교,205,70,275,37.4833837494,127.1289699022
24319,문정1동주민센터.로데오거리,767,950,1717,37.4903961143,127.1245252779
24320,위례포레샤인18단지,549,104,653,37.4892413416,127.1526631771
24321,위례포레샤인18단지,114,602,716,37.4890091099,127.151796207
24322,문덕초등학교.문정고등학교,151,438,589,37.483395,127.126295
24323,문정푸르지오2차아파트,627,126,753,37.4871576085,127.127177779
24324,문정푸르지오2차아파트,138,498,636,37.486845,127.126833
24325,문정동래미안아파트,790,208,998,37.492042028,127.1293381553
24326,문정래미안현대아파트앞,194,653,847,37.491672,127.128978
24327,가락현대1차아파트후문,323,98,421,37.4906606253,127.1276179735
24328,가락현대1차아파트후문,69,446,515,37.490326319,127.127615143
24329,가락현대1차아파트정문,324,862,1186,37.4927542422,127.1289549161
24330,문정역2번출구,29,560,589,37.4862512301,127.124515454
24331,문정역2번출구,765,80,845,37.4861229899,127.1246073352
24332,두댐이공원,207,165,372,37.4892100622,127.1318745943
24333,문정2동주민센터.송파청소년센터,463,580,1043,37.490476805,127.1125408941
24334,훼미리근린공원,524,372,896,37.4911854953,127.114910023
24335,문정로데오거리입구,69,116,185,37.4910256051,127.1194204688
24336,포레나송파정문,604,174,778,37.4870713137,127.1485868096
24337,서울위례별초교,307,244,551,37.478319,127.143837
24338,오금역2번출구,79,224,303,37.5018326648,127.1287989134
24339,오금역3번출구,181,112,293,37.5012913132,127.128894031
24340,장지동,401,483,884,37.4691472156,127.1263366558
24341,위례포레샤인18단지남문,130,71,201,37.4869008429,127.1527658305
24342,힐스테이트센트럴위례,86,103,189,37.486908,127.153384
24343,가윤예식장,601,262,863,37.4927509283,127.1253325788
24344,가락동미륭아파트,686,409,1095,37.4926622084,127.1282354597
24345,가락쌍용1차아파트,414,721,1135,37.4943836148,127.1304312751
24346,송파중학교,685,674,1359,37.4963729647,127.1315012297
24347,가락현대5차아파트,12,95,107,37.500158,127.130629
24348,개롱역3번출구,2249,1258,3507,37.4976665567,127.1353725131
24349,보인고교.가락삼환아파트,736,693,1429,37.496575,127.137465
24350,송파배드민턴체육관,268,356,624,37.494463284,127.1380346597
24351,문정시영.세영청마루아파트,331,403,734,37.4924556056,127.1357194046
24352,문정시영가락프라자아파트,211,181,392,37.4907268695,127.133716891
24353,가락프라자아파트정문,86,178,264,37.4931089642,127.1340582227
24354,가락프라자아파트정문,353,106,459,37.4930607661,127.1342992774
24355,가락극동아파트정문,157,71,228,37.4948883584,127.1321418391
24356,가락극동아파트정문,40,125,165,37.4952844366,127.1313314941
24357,가락동극동아파트,450,479,929,37.4962572557,127.1318312665
24358,가락쌍용1차아파트,376,275,651,37.4939454088,127.1298582661
24359,가주초등학교,39,65,104,37.4971454197,127.128857243
24360,가동초등학교,32,51,83,37.497545667,127.1286578231
24361,가락2동주민센터,31,78,109,37.4988632917,127.1268492824
24362,가락2동주민센터,38,73,111,37.4987661196,127.1267122675
24363,가락시장.가락시장역,689,316,1005,37.4944478594,127.1172843207
24364,문정로데오거리입구,171,491,662,37.4904599734,127.1204716628
24365,문정1동주민센터.로데오거리,705,449,1154,37.490659852,127.124332183
24366,건너말공원입구,222,777,999,37.4927143163,127.1250181262
24367,샛별어린이공원입구,61,129,190,37.4975395069,127.1208958419
24368,샛별어린이공원입구,69,118,187,37.4975895389,127.121253598
24369,송파경찰서.오금역,2067,2058,4125,37.5026698156,127.1268712547
24370,가락쌍용2차아파트,152,118,270,37.5025149139,127.1221012808
24371,가락대림아파트,366,303,669,37.4996815135,127.1179869266
24372,신가초등학교,239,106,345,37.498817,127.120215
24373,신가초등학교,104,261,365,37.4984292292,127.1201688051
24374,석촌중학교후문,152,37,189,37.4998335741,127.1229196393
24375,석촌중학교후문,46,100,146,37.4998583625,127.123203452
24376,포레나송파,77,31,108,37.484704625,127.149250645
24377,경찰병원.KT가락지사,195,273,468,37.4959261628,127.1222432156
24378,경찰병원.KT가락지사,398,227,625,37.496234994,127.1223707692
24379,경찰병원.서울동부고용노동지청,833,761,1594,37.4946736667,127.1223372934
24380,가락시장역4번출구.제일오피스텔,399,977,1376,37.4932167146,127.1197227845
24381,위례호반써밋,18,84,102,37.484321154,127.14964829
24382,경찰병원.서울동부고용노동지청,305,585,890,37.4944255943,127.1226224186
24383,북위례입구,68,75,143,37.488952,127.156522
24385,가락시장.가락시장역,210,407,617,37.4937628733,127.1171509252
24386,가락시장.가락몰,467,704,1171,37.491843,127.115874
24387,가락시장남문,387,410,797,37.4907819227,127.1122487287
24388,가락시장.헬리오시티,428,613,1041,37.4943840396,127.1049619108
24389,가락시장.헬리오시티,670,255,925,37.4951999021,127.1062542896
24390,가락1동주민센터,232,360,592,37.4962977643,127.1098466383
24391,서울방이동고분군,777,687,1464,37.5082096607,127.116198465
24392,문정푸르지오1차아파트,94,260,354,37.4866641411,127.1283056048
24393,토성오거리,107,83,190,37.5320618822,127.119083394
24394,풍납토성서성벽,55,294,349,37.5297957798,127.1098762971
24395,가락시장동문,28,264,292,37.4951463191,127.1160111131
24396,몽촌토성역.한성백제역,900,936,1836,37.5170403874,127.1136027575
24397,풍납동강변현대아파트,89,115,204,37.5336350409,127.1112169853
24398,서울위례별초교.위례별유치원,222,115,337,37.4780339719,127.1448746324
24399,송례중학교.송파꿈에그린,214,166,380,37.4773101292,127.1414973009
24400,홍이공원,57,80,137,37.5002054217,127.1247919705
24401,홍이공원,75,47,122,37.500414976,127.1248261618
24402,송파파크센트럴,89,166,255,37.4926552279,127.1495066063
24403,거여역7번출구,1287,633,1920,37.492387,127.143927
24404,거여역6번출구,388,978,1366,37.4919573794,127.1440917844
24405,덕수고등학교,79,178,257,37.4855576081,127.1462249529
24406,풍납2동주민센터,73,172,245,37.52956,127.116059
24408,오륜사거리,199,61,260,37.5053972109,127.1392233095
24409,오륜사거리,47,183,230,37.5045363345,127.1386561317
24410,위례중앙푸르지오.신안인스빌,229,239,468,37.4748414391,127.1433042987
24411,위례신안인스빌.중앙푸르지오,165,259,424,37.4757124112,127.1439249265
24412,송파와이즈더샵.위례센트로엘,190,201,391,37.4771037831,127.1440806985
24413,송파와이즈더샵.위례센트로엘,68,137,205,37.4776084685,127.144389265
24414,위례별초등학교.위례스타힐스,159,172,331,37.4795390683,127.1442346974
24415,위례별초등학교.위례스타힐스,344,132,476,37.4803383177,127.1445584544
24416,위례동주민센터.위례스타힐스,137,322,459,37.4813570555,127.1436820638
24417,위례동주민센터.위례송파푸르지오,343,80,423,37.4815613884,127.1429793251
24418,힐스테이트송파.송파더센트레,31,194,225,37.4794843685,127.1419922382
24419,송파더센트레.힐스테이트송파,234,34,268,37.4794453423,127.1416454766
24420,복정역2번출구,65,688,753,37.4692838154,127.1268694814
24421,세계로병원,951,172,1123,37.4865518064,127.1418426303
24422,세계로병원,98,568,666,37.487287,127.141787
24423,덕수고등학교,221,143,364,37.4854313904,127.146286894
24424,송파레이크파크호반써밋1차,130,604,734,37.4838955381,127.140415813
24425,송파레이크파크호반써밋2차,547,178,725,37.4834695741,127.1406157055
24426,위례포레샤인13단지,336,186,522,37.4829560499,127.1386672185
24427,송파레이크파크호반써밋1차정문,179,194,373,37.4831887542,127.1380740615
24428,송파위례리슈빌,185,355,540,37.4841838117,127.1478419413
24429,남한산성입구,229,236,465,37.49096,127.157278
24430,서울아산병원장례식장,473,219,692,37.524639581,127.1074534384
24431,갑을.미성아파트,143,151,294,37.5352961895,127.1124809949
24432,송파배드민턴체육관,117,277,394,37.494207337,127.1380635927
24434,풍납중학교앞,61,152,213,37.5247728207,127.1152307919
24435,복정역3번출구,76,47,123,37.4697320643,127.1239612069
24436,새마을시장,775,285,1060,37.5088577164,127.0867330139
24437,잠실학원사거리.잠실트리지움남문,228,415,643,37.5075860124,127.0893716473
24438,삼전역.잠실현대아파트,359,72,431,37.5037577444,127.0872894577
24439,위례포레샤인.위례31단지후문,1153,478,1631,37.4748523857,127.1339747337
24440,위례31단지.위례포레샤인후문,280,1124,1404,37.474649928,127.1337369645
24441,위례송파더센트레.송파푸르지오,315,55,370,37.4794716366,127.1384657534
24442,장지역2번출구,670,2347,3017,37.4782723708,127.126673162
24443,위례송파푸르지오.송파더센트레,36,258,294,37.480622,127.13887
24444,가락시장역5번출구,1434,616,2050,37.4926740479,127.1195353388
24445,올림픽대교남단교차로,70,121,191,37.525152,127.11681
24446,장지공영차고지,1057,35,1092,37.4805107902,127.1358870728
24447,장지공영차고지,1,868,869,37.4805606249,127.1356440835
24448,아이코리아,267,54,321,37.4809686394,127.1333949101
24449,송파파인타운11.12단지,2,188,190,37.479127,127.132114
24450,송파파인타운7단지,63,14,77,37.479031172,127.1316532003
24451,송파파인타운10단지.13단지,20,132,152,37.4775944779,127.1292369392
24452,송파파인타운8단지.9단지,209,134,343,37.4780867697,127.1274733427
24453,송파구립산모건강증진센터,419,217,636,37.4779844895,127.1273092136
24454,장지동주민센터앞,294,111,405,37.486694466,127.132886471
24455,장지동주민센터.송파파인타운1단지,78,163,241,37.486505,127.132993
24456,잠실여고후문,308,367,675,37.5025010936,127.1116190362
24457,건영아파트앞,40,205,245,37.481838,127.126489
24458,잠실새내역2번출구,234,1471,1705,37.5104224501,127.0860380725
24459,가락래미안앞,196,673,869,37.499257,127.132413
24460,서울버스종점,62,1,63,37.4806082049,127.1369279275
24461,서울버스종점,0,52,52,37.4803796141,127.1377801895
24462,송파파인타운2단지.한림예고,124,470,594,37.485133,127.132647
24463,송파파인타운3단지.한림예고,635,140,775,37.484826,127.132645
24464,송파글마루도서관.버들어린이집,281,86,367,37.481607,127.131555
24465,송파글마루도서관.버들어린이집,49,290,339,37.481598,127.131337
24466,문현고등학교.송파파인타운5단지,163,211,374,37.480632,127.129475
24467,문현고등학교,324,203,527,37.4806625366,127.1291235096
24468,풍납현대아파트,749,808,1557,37.5287587812,127.1193610526
24469,문정3차푸르지오아파트.송파파인타운1단지,462,12,474,37.4866738525,127.1335864078
24470,문정3차푸르지오아파트.송파파인타운1단지,5,310,315,37.4864839486,127.1333836546
24471,아이코리아앞,31,272,303,37.48096,127.13364
24472,가든파이브웍스동,40,187,227,37.478215,127.121195
24473,가든파이브웍스동,80,59,139,37.4782546079,127.1212593757
24475,장지역.가든파이브라이프동,738,510,1248,37.4790724082,127.1246144045
24476,장지역.가든파이브라이프동,788,817,1605,37.479007,127.124888
24477,가든파이브툴동,397,82,479,37.4791477338,127.1193612432
24478,가든파이브툴동,205,386,591,37.4789969804,127.1193072186
24479,잠실대교전망쉼터,103,216,319,37.5201071463,127.0951336442
24480,잠실대교전망쉼터,150,700,850,37.519993,127.09479
24481,석촌호수서호사거리,127,285,412,37.5063212494,127.0984075632
24482,석촌호수서호사거리,321,93,414,37.5065890171,127.099235139
24483,미켈란호수가아파트,68,145,213,37.5076563193,127.1026500655
24484,미켈란호수가아파트,112,59,171,37.5081977473,127.1031124564
24485,호수임광아파트,43,203,246,37.5106263397,127.1067263617
24486,호수임광아파트,236,33,269,37.5113882396,127.1072025448
24487,송파파인타운아파트11단지,1,21,22,37.4783671481,127.1332433117
24488,송파파인타운아파트11단지,7,12,19,37.4784596838,127.1331775188
24489,문정중학교후문,29,371,400,37.4886487088,127.1302736326
24490,문정동래미안아파트남문,460,41,501,37.4888309722,127.130446385
24491,파크데일아파트입구,129,181,310,37.4975389586,127.1548937216
24492,위례아이파크아파트앞,741,977,1718,37.4758687793,127.1411478405
24493,송파더센트레.송례초앞,475,66,541,37.4785382811,127.1391565065
24494,송파더센트레.송례중앞,40,557,597,37.4782159275,127.1407082374
24495,송파꿈에그린아파트,1079,772,1851,37.4749448409,127.1407699426
24496,송파푸르지오시티.한화오벨리스크,521,93,614,37.4810278722,127.1201781904
24497,송파푸르지오시티.한화오벨리스크,62,506,568,37.480800155,127.1203869879
24498,파크데일아파트입구,83,75,158,37.4977775358,127.1547623047
24500,복정역환승센터2번승강장,7,1467,1474,37.4698297575,127.1274120389
24502,송파.잠실세무서,181,44,225,37.5267839464,127.1153594729
24503,복정역환승센터3번승강장,1805,24,1829,37.4699297672,127.1275897549
24505,송파역,27,872,899,37.4998736805,127.1123582001
24506,복정역환승센터4번승강장,1842,34,1876,37.4698272579,127.1276409489
24508,송파역.헬리오시티,805,79,884,37.499696,127.11185
24509,송례중학교.위례아이파크,83,200,283,37.4776912721,127.1418222785
24510,잠실4동주민센터.파크리오B상가,176,134,310,37.5201133052,127.1130749603
24511,송파호반베르디움더퍼스트,19,0,19,37.5068525741,127.1409196828
24512,오륜사거리,3,0,3,37.5076048967,127.1390323102
24513,세륜중학교,66,1,67,37.5077359773,127.1327808841
24514,오금공원,24,12,36,37.5063719498,127.1318934673
24515,오금역.오금고교,10,54,64,37.503023576,127.1288453455
24516,송파삼성래미안아파트,114,67,181,37.5046817564,127.1199757658
24517,송파현대아파트.가락중학교,192,18,210,37.5029952401,127.1182081377
24518,가락고등학교,28,16,44,37.5016524892,127.1173726287
24519,가락동부센트레빌아파트,16,71,87,37.4992940827,127.1173972093
24520,가락중학교,16,62,78,37.5020916893,127.1174128987
24521,가락중학교.래미안송파파인탑,38,201,239,37.5030501232,127.1185509959
24522,가락삼익맨숀,28,60,88,37.5053206649,127.1207656439
24523,오금역.오금고교,84,23,107,37.5026426706,127.1290567413
24524,오금공원,2,47,49,37.5053450242,127.1316965673
24525,세륜중학교,1,61,62,37.5069768763,127.1327851946
24526,송파호반베르디움더퍼스트,0,27,27,37.5066071049,127.1408739816
24527,송파파인타운1단지,28,6,34,37.4859240011,127.1335563626
24528,송파파인타운2단지,20,4,24,37.4831672798,127.1312223337
24529,송파파크하비오푸르지오,49,27,76,37.481230834,127.1221457814
24530,서울동부지방법원.검찰청,31,19,50,37.4835093905,127.1209227388
24531,문정법조단지,81,53,134,37.4857852983,127.1178396471
24532,올림픽훼밀리타운아파트,26,1,27,37.486396637,127.1143350005
24533,올림픽훼밀리타운아파트,10,60,70,37.4861852124,127.1143068773
24534,문정법조단지,48,88,136,37.485461563,127.1172087865
24535,서울동부지방법원.검찰청,27,16,43,37.4839333746,127.120423108
24536,송파아이파크오피스텔,56,49,105,37.480135894,127.1223531594
24537,송파파인타운3단지,3,59,62,37.4834955431,127.1317656182
24538,송파파인타운1단지,8,37,45,37.4856559756,127.13362813
24540,석촌역4번출구,10,130,140,37.5044971537,127.1082077956
24542,잠실역.롯데호텔,173,8,181,37.5117453632,127.1009963581
24543,석촌역5번출구,130,21,151,37.5043918616,127.1075771324
24544,송파레이크힐아파트,104,118,222,,
24545,송파레이크파크호반써밋2차정문,41,0,41,,
24546,송파레이크파크호반써밋1차후문,13,2,15,37.4853779376,127.1402122392
24547,문정역테라타워,20,48,68,37.4847083381,127.1203282453
24548,서울한방병원,159,28,187,37.4856051778,127.1154762459
24549,문정2동주민센터,1,14,15,37.48915151,127.1098421786
24550,힐스테이트에코송파,33,116,149,37.4856008742,127.1152698905
24551,문정현대지식산업센터,25,59,84,37.4855041652,127.1196511155
24552,송파레이크파크호반써밋1차후문,0,32,32,37.4851045404,127.1400480883
24553,롯데월드.샤롯데,4,1,5,37.5108000421,127.1007138773
24554,잠실롯데월드,1,1,2,37.5101322868,127.0986613969
24555,레이크팰리스아파트,12,3,15,37.5089193339,127.0972742883
24556,삼전동주민센터,33,8,41,37.503537,127.091536
24557,삼전역,10,96,106,37.5039049824,127.0890344319
24559,레이크팰리스아파트,1,3,4,37.5083717341,127.0975648159
24560,잠실롯데월드,1,9,10,37.5098484849,127.0986440577
24561,롯데월드.샤롯데,0,14,14,37.5105673984,127.1008816654
24563,잠실역.시그마타워,11,15,26,,
24565,잠실역2번출구,12,133,145,37.512089,127.101458
24653,위례포레샤인.송파꿈에그린서문,573,430,1003,37.4773218515,127.1372888376
24654,송파꿈에그린서문.위례포레샤인,466,600,1066,37.4766121113,127.1374571207
24658,복정역환승주차장,6,1561,1567,37.470728,127.128144
24904,풍납초등학교,71,137,208,37.533949,127.11855
24907,풍납백제문화공원,182,193,375,37.535044,127.114721
24912,송파레미니스아파트,0,55,55,37.5078664119,127.136912144
24913,송파레미니스아파트,25,1,26,37.5082386325,127.137183599
25002,상일초교,403,810,1213,37.5457940987,127.1706308587
25003,초이동,227,175,402,37.5421385963,127.1615969135
25004,초이동,148,382,530,37.5418463392,127.1610838354
25005,강동자이.프라자아파트,749,295,1044,37.5367333585,127.1488398094
25006,강동자이?프라자아파트,199,449,648,37.5362100889,127.1477890164
25007,길동주민센터.둔촌2동주민센터,679,329,1008,37.5342743542,127.1429328548
25008,길동주민센터.둔촌2동주민센터,269,718,987,37.533885728,127.142104768
25009,길동사거리.강동세무서,1132,1685,2817,37.5345204402,127.1367996291
25010,길동사거리.강동세무서,438,751,1189,37.5347332654,127.1358552825
25011,강동역,946,1749,2695,37.5359016775,127.1324489471
25012,강동역,1439,1170,2609,37.5361076979,127.1315158731
25013,천호역,1465,1807,3272,37.5376532944,127.1270521339
25014,천호역,1647,2610,4257,37.5379482005,127.1255385876
25101,강동공영차고지,1214,173,1387,37.5640659626,127.1738851475
25102,강동공영차고지,23,629,652,37.5641768855,127.1743327049
25103,고덕리엔파크1단지,1092,141,1233,37.5611595214,127.1704714177
25104,고덕리엔파크1단지,58,672,730,37.561365,127.170696
25105,해뜨는주유소,619,619,1238,37.559100428,127.1708038471
25106,해뜨는주유소,318,904,1222,37.559757,127.170989
25107,고덕천교차로,301,70,371,37.5563241348,127.171147352
25108,고덕천교차로,15,282,297,37.556043,127.171561
25109,고덕자이.고덕천물놀이장,725,194,919,37.5534666908,127.1720516501
25110,강명초등학교.고덕천물놀이장,147,406,553,37.553372,127.172373
25111,고덕자이,721,286,1007,37.5516025716,127.1725023454
25112,고덕리엔파크3단지,157,421,578,37.55188966,127.1727253894
25113,상일동산.롯데캐슬베네루체,321,54,375,37.5499723005,127.1651954955
25114,상일동산.롯데캐슬베네루체,51,289,340,37.549944934,127.1654359105
25115,상일근린공원,311,70,381,37.5473142929,127.1670055389
25116,상일근린공원,104,428,532,37.5473948164,127.1672436805
25117,GS강동자이아파트.둔촌동프라자아파트,169,69,238,37.5370016433,127.1490315784
25118,둔촌동프라자아파트.GS강동자이아파트,84,62,146,37.5361286235,127.1480886874
25119,둔촌푸르지오아파트,137,80,217,37.5350319702,127.1441944201
25120,둔촌푸르지오아파트,35,129,164,37.5346425877,127.1446715983
25121,길동주민센터.서울양병원,94,78,172,37.5341203242,127.1418251888
25122,둔촌2동주민센터.서울양병원,68,142,210,37.533652,127.141927
25123,길동사거리.강동세무서,639,148,787,37.5344456779,127.1375233178
25124,길동사거리.강동세무서,816,454,1270,37.5341240126,127.1371820569
25125,강동역1번출구.동신중학교,758,422,1180,37.5362807584,127.1318584385
25126,강동역.강풀만화거리입구,580,358,938,37.5360510195,127.1309700608
25127,천호역5번출구,827,534,1361,37.5377884776,127.127021248
25128,천호역6번출구,1482,750,2232,37.5372250644,127.1272890134
25131,상일동역4번출구.센트럴푸르지오,1594,2423,4017,37.5572370526,127.1696338816
25132,상일동역6번출구.고덕아르테온,2315,1217,3532,37.5568093436,127.1678730363
25133,상일동역1번출구,869,396,1265,37.5565176079,127.1639451385
25134,상일동역8번출구,826,1005,1831,37.5563907851,127.1648526809
25135,고덕그라시움,317,184,501,37.5561075345,127.160701874
25136,고덕그라시움,177,523,700,37.5557278909,127.1602719709
25137,고덕평생학습관.온조대왕체육관,570,766,1336,37.5556884118,127.1581417355
25138,고덕평생학습관.온조대왕체육관,47,168,215,37.5555051376,127.1580919351
25139,고덕역,816,951,1767,37.555373079,127.15584924
25140,고덕역,1194,1016,2210,37.55504,127.154997
25141,배재중고등학교,412,172,584,37.5548565699,127.1493253657
25142,배재중고등학교,126,396,522,37.5545407237,127.1497180078
25143,동부기술교육원.장애인종합복지관,125,141,266,37.5547923189,127.146584873
25144,동부기술교육원.장애인종합복지관,130,199,329,37.5546166466,127.1457517147
25145,명일초등학교,355,412,767,37.5548673708,127.1434373656
25146,명일초등학교,234,473,707,37.554602,127.143468
25147,암사3동주민센터,465,687,1152,37.5548779586,127.1391936489
25148,암사3동주민센터프라이어팰리스,716,490,1206,37.5545587211,127.1393191473
25149,강일중.선사고,582,549,1131,37.5548602212,127.1370263647
25150,강일중.선사고,665,648,1313,37.5546247899,127.1360922644
25151,신암중학교,595,431,1026,37.5548390685,127.1313639495
25152,신암중학교,493,480,973,37.5546138434,127.1313205443
25153,삼성광나루아파트,480,990,1470,37.55338,127.128557
25154,삼성광나루아파트,722,446,1168,37.5532319019,127.1288157342
25155,암사역선사현대아파트,900,1512,2412,37.5506992115,127.1275580607
25156,암사역2번출구.암사종합시장,1403,976,2379,37.5496007079,127.127528264
25157,천호동공원,879,465,1344,37.5459692284,127.1259116562
25158,천호동공원,537,908,1445,37.5460717587,127.1262318717
25159,서울현대요양병원,726,831,1557,37.5431697481,127.1248606353
25160,서울현대요양병원,756,629,1385,37.5420613974,127.124856045
25161,천호역2번출구.현대백화점,1065,2822,3887,37.5403483565,127.123922439
25162,천호역3번출구.현대백화점,3298,1222,4520,37.5399531076,127.1240057241
25163,천호역8번출구,817,1129,1946,37.535973076,127.1227694856
25164,강동구청역1번출구.영파여고,1458,929,2387,37.5321522885,127.1213543415
25165,상일동역2번출구,128,475,603,37.5573380664,127.1651251793
25166,상일동역2번출구,423,81,504,37.5571801903,127.1654238958
25167,고덕초등학교,68,107,175,37.5601690579,127.1653906056
25168,고덕초등학교,37,78,115,37.5600425618,127.1656449814
25169,강덕초등학교.고덕그라시움,222,179,401,37.5603785827,127.16279594
25170,강덕초등학교.고덕그라시움,138,186,324,37.5602581374,127.1628838541
25171,광문고.서울컨벤션고,108,234,342,37.5605856361,127.1576291349
25172,광문고.서울컨벤션고,83,57,140,37.5604492511,127.1565150315
25173,고덕아이파크아파트,456,125,581,37.5597406341,127.1540688553
25174,고덕아이파크아파트,161,370,531,37.5593688285,127.1537814711
25175,명일중학교,304,97,401,37.5582427163,127.1487291657
25176,명일중학교,91,162,253,37.5584235613,127.1488761534
25177,강동경희대병원.명일동이마트,866,588,1454,37.5545494691,127.1567607504
25178,강동아트센터.강동경희대병원,1716,1003,2719,37.5523444556,127.1561087396
25179,강동아트센터.강동경희대병원후문,633,876,1509,37.5510654125,127.1564472994
25180,한영중고한영외고,558,152,710,37.548057,127.155872
25181,한영중고한영외고,178,461,639,37.5480044986,127.156276817
25182,길동자연생태공원,257,147,404,37.539039881,127.1525922642
25183,길동자연생태공원,59,199,258,37.5391799069,127.1530135068
25184,일자산입구.둔촌도서관,93,861,954,37.5319956052,127.149622018
25185,일자산입구.둔촌도서관,75,109,184,37.5314894776,127.149868095
25186,서하남IC입구,68,98,166,37.5176144108,127.1433323234
25187,동북고등학교.둔촌오륜역,215,101,316,37.5189585979,127.1400431567
25188,오륜교회앞,219,360,579,37.5224763077,127.1320753742
25190,보훈병원,467,135,602,37.5289127518,127.1435151543
25191,보훈병원,174,316,490,37.529879855,127.1428079276
25192,약수터,588,221,809,37.5323253058,127.14163794
25193,약수터,284,571,855,37.5325058105,127.1413837195
25194,명일여자고등학교,279,140,419,37.5484260207,127.149072066
25195,명일여자고등학교,112,259,371,37.5483514975,127.1493031571
25196,길동성당,231,146,377,37.5444066925,127.1479777593
25197,길동성당,151,182,333,37.544390659,127.1481898961
25198,길동신동아아파트,399,223,622,37.5413040547,127.1471322012
25199,길동신동아아파트,204,278,482,37.5413876109,127.1473292706
25202,강일리버5단지.미사강변루나리움,5,61,66,37.567494,127.17919
25204,보훈회관,232,189,421,37.5264562493,127.1452995611
25205,보훈회관,175,247,422,37.5262975611,127.1453852609
25206,신암중.선사고,69,69,138,37.55657,127.134587
25207,신암중.선사고,6,20,26,37.556546,127.133034
25208,암사역사공원역1번출구,947,71,1018,37.55731,127.138716
25209,암사역사공원역3번출구,35,876,911,37.55711,127.137212
25210,대순진리회,103,106,209,37.5303537171,127.1312576314
25211,대순진리회,104,97,201,37.5302518225,127.1309512282
25212,성내2동주민센터.성내복지관,131,110,241,37.531255132,127.1280340549
25213,성내2동주민센터.성내복지관,88,71,159,37.5310374848,127.1281257543
25214,성내삼성청구아파트,104,101,205,37.5319215281,127.1255463243
25215,성내삼성청구아파트,134,74,208,37.5315856264,127.1261519928
25216,성내주유소,27,143,170,37.5329248061,127.1220776578
25217,성내주유소,79,42,121,37.5327031853,127.1222823858
25218,강동농협,138,79,217,37.5409643096,127.1427532477
25219,강동농협,136,101,237,37.540733131,127.1431647199
25220,참잘함한방병원,214,133,347,37.5411335464,127.1398826123
25221,참잘함한방병원,515,515,1030,37.5409317609,127.1400389837
25222,천동초등학교.천호도서관,115,89,204,37.5404236471,127.136664078
25223,천동초등학교.천호도서관,293,423,716,37.540437,127.136948
25224,강동성심병원,320,560,880,37.537458,127.1355
25225,강동성심병원,112,150,262,37.5373426452,127.1352326667
25226,조은마디병원,71,80,151,37.5341470568,127.1339143218
25227,조은마디병원,47,78,125,37.5344721128,127.1337616896
25230,JYP엔터테인먼트.윤선생영어교실,1047,756,1803,37.5247728157,127.1291706243
25231,JYP엔터테인먼트.윤선생영어교실,601,526,1127,37.5249590467,127.1294413478
25232,명일역3번출구.래미안솔베뉴,1463,754,2217,37.5518873966,127.1442239125
25233,명일역2번출구,567,982,1549,37.5521499237,127.1439708949
25234,명일역1번출구.명일전통시장,646,369,1015,37.5500246088,127.143670283
25235,명일역4번출구.명일전통시장,365,629,994,37.5503142792,127.1440658281
25236,굽은다리사거리,339,301,640,37.5479101562,127.143327835
25237,굽은다리사거리,272,399,671,37.5472655932,127.143558605
25238,십자성마을,664,277,941,37.5434576822,127.1419714912
25239,십자성마을,395,658,1053,37.5429790193,127.1421222263
25240,길동역1번출구,1411,1047,2458,37.5379724338,127.1399400757
25241,길동역3번출구,491,436,927,37.5373136521,127.1400078708
25242,서울프라임한방병원,767,458,1225,37.5355253414,127.1389352122
25243,서울프라임한방병원,616,703,1319,37.535436462,127.1393639919
25244,강동리바트,658,668,1326,37.5313641488,127.1373320955
25245,동명약국앞,688,432,1120,37.529719,127.137186
25246,둔촌동역4번출구,1021,1449,2470,37.5282558591,127.1361248068
25247,둔촌동역2번출구,354,628,982,37.52774,127.136548
25248,한국전력공사강동송파지사,871,817,1688,37.524796,127.13491
25249,한국전력공사강동송파지사,1159,817,1976,37.5244872348,127.1353304596
25250,고덕자이.상일여고,788,121,909,37.5509164233,127.1712887597
25251,고덕자이.상일여고,106,539,645,37.550846179,127.1721418273
25252,상일1동주민센터.고덕사회체육센터,551,44,595,37.5504652771,127.1681684889
25253,상일1동주민센터.롯데캐슬베네루체,101,585,686,37.5502885957,127.1682562999
25254,고덕숲아이파크,85,27,112,37.5506341451,127.1646290433
25255,고덕숲아이파크,21,125,146,37.550453945,127.1647425084
25256,강동고등학교,122,132,254,37.5502212128,127.1603416661
25257,강동고등학교,66,120,186,37.5502623446,127.1606808361
25259,한영중고앞사거리,34,103,137,37.5492276384,127.1567382863
25260,고덕현대아파트,777,347,1124,37.5492766686,127.1532127307
25261,한영중고앞사거리,339,540,879,37.5490766847,127.1556548346
25262,고덕삼환.주공9단지아파트,867,368,1235,37.5492742341,127.1516086272
25263,고덕삼환.주공9단지아파트,570,882,1452,37.5491249477,127.1520920996
25264,명일여자고등학교,629,422,1051,37.5494552042,127.1484178305
25265,명일여자고등학교,392,627,1019,37.5491493481,127.1488528373
25266,명일1동주민센터,723,502,1225,37.5504780577,127.1462720633
25267,명일1동주민센터,729,608,1337,37.5501976117,127.1463681139
25268,강동롯데캐슬퍼스트,64,102,166,37.558453,127.143043
25269,강동롯데캐슬퍼스트,34,304,338,37.5586,127.143034
25270,래미안힐스테이트고덕,13,167,180,37.561812,127.150388
25271,래미안힐스테이트고덕,134,12,146,37.5620876642,127.1514603982
25272,샘터근린공원교차로,9,63,72,37.5622840097,127.1540143466
25273,샘터근린공원교차로,102,16,118,37.56246,127.153899
25274,고덕풍경채어바니티,18,62,80,37.562326533,127.1686082459
25275,고덕풍경채어바니티,122,16,138,37.562416,127.169549
25276,올림픽파크포레온121동앞,271,81,352,37.524908,127.140955
25277,올림픽파크포레온418동앞,102,180,282,37.524184,127.1409
25278,동북중학교,162,27,189,37.520423,127.139261
25279,동북중학교,57,243,300,37.520063,127.139267
25281,강동구청,157,450,607,37.5302045345,127.1225423765
25282,강동구청,631,406,1037,37.5299251982,127.1225673748
25283,강동보건소앞,289,280,569,37.5288274095,127.1254928964
25284,강동보건소건너,329,459,788,37.5285596644,127.125423019
25285,한양수자인아파트,401,217,618,37.5273514477,127.1286297229
25286,한양수자인아파트,386,563,949,37.5272203296,127.1285588725
25287,서울장애인복지관,27,99,126,37.5552000891,127.1490836595
25288,서울장애인복지관,65,39,104,37.5550804924,127.14888648
25289,명일동신동아아파트,26,45,71,37.5549528287,127.152321267
25290,명일동신동아아파트,55,70,125,37.5545613021,127.1518429396
25291,고덕비즈밸리입구교차로,1,165,166,37.563965,127.160845
25292,고덕비즈밸리입구교차로,74,7,81,37.563745,127.160736
25293,지식산업센터,930,318,1248,37.565741,127.159377
25294,강동아이파크더리버,458,66,524,37.566005,127.157905
25297,상일동주몽재활원,70,14,84,37.5459774785,127.1633225482
25298,상일동주몽재활원,15,62,77,37.5457576125,127.1636849642
25299,상일동빌라단지,22,109,131,37.545459898,127.1591117744
25300,상일동빌라단지,83,14,97,37.5456169539,127.1595703997
25301,강동아이파크더리버,38,516,554,37.565636,127.157665
25302,중앙보훈병원1번출구,268,71,339,37.5279919512,127.1480518756
25303,중앙보훈병원1번출구,456,364,820,37.5272087335,127.148076709
25304,샘터근린공원,20,4,24,37.563923,127.156808
25305,샘터근린공원,1,175,176,37.563775,127.157125
25306,고덕산생태육교,23,27,50,37.561295,127.147648
25307,고덕산생태육교,8,126,134,37.560545,127.146161
25309,강동첨단업무단지.상일여고입구,1348,218,1566,37.5486425295,127.1730829007
25310,강동첨단업무단지.상일여고입구,330,1192,1522,37.5494046152,127.1732465045
25311,천동초교입구사거리,304,407,711,37.5399553721,127.1410120284
25312,천동초교입구사거리,344,418,762,37.5399404705,127.1406623307
25313,강동구청역농협중앙회,1019,921,1940,37.5291461005,127.1201139304
25314,성내구립도서관.사회적경제지원센터,46,57,103,37.5326925318,127.1332543151
25315,성내구립도서관.사회적경제지원센터,65,62,127,37.5322659606,127.1327670107
25317,강일리버파크6단지,47,58,105,37.5638687832,127.1755232692
25318,강일동주민센터,329,1053,1382,37.566015,127.173929
25319,강일동주민센터,462,180,642,37.5657160096,127.1738750475
25320,강일리버파크4단지.2단지,414,274,688,37.568441,127.176556
25321,강일리버파크2단지.4단지,398,292,690,37.5686218353,127.1765456511
25322,강일고등학교.강일리버파크7단지,123,286,409,37.565067,127.177918
25323,강일고등학교.강일리버파크7단지,487,254,741,37.5647110133,127.1784008104
25324,강일리버파크6단지,2,22,24,37.5628090509,127.176236674
25326,강일초등학교,206,346,552,37.565095,127.175752
25327,강일초등학교,565,224,789,37.5658737494,127.1768636035
25328,강일리버파크9단지.10단지,589,236,825,37.5595533554,127.1794626974
25329,강일리버파크10단지.9단지,108,478,586,37.5595583711,127.1797196537
25330,중앙보훈병원역2번출구,441,2301,2742,37.5295979733,127.1486791218
25331,중앙보훈병원역3번출구,2343,451,2794,37.529322747,127.1489407046
25332,강일리버파크8단지,341,5,346,37.5622718862,127.1777180853
25333,강일리버파크8단지,1,227,228,37.562648,127.177967
25334,강일리버파크4단지.5단지,292,142,434,37.56656,127.177374
25335,강일리버파크5단지.4단지,240,417,657,37.567123716,127.1774839621
25336,강일리버파크1단지.3단지,481,105,586,37.5670368114,127.1733008447
25337,강일리버파크3단지.1단지,86,196,282,37.568207,127.174408
25338,상일파출소.고덕아르테온,57,271,328,37.555557676,127.1657708619
25339,강일리버파크9단지후문,83,465,548,37.5616924212,127.18013794
25340,강일리버파크9단지후문,670,95,765,37.561716212,127.1799002887
25341,강동공영차고지,34,1,35,37.564251,127.174627
25342,강일역.고덕리엔파크2단지.3단지,322,312,634,37.557258,127.173781
25343,강일역.고덕리엔파크3단지.2단지,170,367,537,37.5570976195,127.1741238123
25344,고덕리엔파크2단지,25,12,37,37.5568389632,127.1730237586
25345,강명초등학교.고덕리엔파크3단지,103,11,114,37.5540437436,127.1737828521
25346,강명초등학교.고덕리엔파크3단지,17,62,79,37.5538259097,127.1733353217
25347,고덕리엔파크2단지,1,48,49,37.5568348591,127.1733644426
25348,굽은다리역구민회관.강동홈플러스,791,527,1318,37.545694751,127.1427891583
25349,굽은다리역구민회관.강동홈플러스,537,637,1174,37.545612,127.143063
25350,삼성E&A,215,61,276,37.5499109397,127.174955829
25351,삼성E&A,31,111,142,37.5498684022,127.1747803242
25352,고덕리엔파크3단지서문,229,5,234,37.5512572809,127.1738483769
25353,고덕리엔파크3단지서문,8,221,229,37.5510707551,127.1738479436
25357,천동초교삼거리,193,129,322,37.5415666821,127.1367999069
25358,천동초교삼거리,102,124,226,37.5419296212,127.1362376583
25359,동아하이빌,153,81,234,37.544085363,127.1341268185
25360,동아하이빌,70,214,284,37.5438916969,127.1340840381
25361,천일초교사거리,148,134,282,37.5446006791,127.1323090477
25362,천일초교사거리,69,154,223,37.5445369862,127.1312462814
25363,천일중.구강사,219,114,333,37.5451182045,127.1290082846
25364,천일중.구강사,166,239,405,37.5449352859,127.1290018939
25365,고덕센트럴.고덕숲아이파크,152,96,248,37.551342,127.165386
25366,고덕숲.고덕센트럴아이파크,117,193,310,37.551649,127.165146
25367,고현초등학교.고덕센트럴아이파크,95,97,192,37.552914,127.165331
25368,고현초등학교.고덕숲아이파크,120,114,234,37.5539659708,127.1650716662
25369,현대토파즈아파트,131,41,172,37.5253053335,127.1258610776
25370,성내유수지체육공원,19,10,29,37.527080206,127.1218418512
25371,서울시동부기술교육원.명덕초교,225,345,570,37.5562272083,127.1448067818
25372,아남.대우아파트,560,344,904,37.5577139082,127.1447615587
25373,강동롯데캐슬퍼스트아파트,262,718,980,37.5569077643,127.1445591127
25374,천호역1번출구.문구거리,624,176,800,37.5392936965,127.1222319467
25375,강동리버스트7.6단지,25,1216,1241,37.5706447521,127.1721319634
25376,강동리버스트6.7단지,1473,48,1521,37.5704941,127.1719505031
25377,강동리버스트상가,40,1095,1135,37.5720993671,127.1740030851
25378,힐스테이트리슈빌강일501동,1334,25,1359,37.5724769381,127.1746743791
25379,강동리버스트8단지,21,327,348,37.5729462716,127.1770529573
25381,강일역3번출구,1052,485,1537,37.5576403005,127.177015543
25382,상일2동주민센터.고덕어반브릿지,3,186,189,37.556006698,127.1794170581
25383,상일2동주민센터.고덕어반브릿지,195,85,280,37.556268,127.179726
25384,강동리엔파크11단지,1,152,153,37.5540623911,127.1793876953
25385,강동리엔파크11단지,167,1,168,37.553588681,127.1798392415
25386,강동리엔파크13.14단지,38,283,321,37.5512590584,127.1816669472
25387,강동리엔파크13.14단지,340,22,362,37.5513716529,127.1817343335
25388,강일역2번출구,233,1042,1275,37.5579262075,127.17737109
25501,가래여울,30,1,31,37.5765373836,127.1689220104
25505,신명초교입구교차로,109,72,181,37.5400880474,127.1467529825
25508,길동초등학교,238,94,332,37.5390026354,127.1464238219
25509,강일리버파크1단지103동,12,7,19,37.5680002929,127.1727484509
25510,길동우성아파트.은평교회맞은편,206,132,338,37.5363256639,127.1455450213
25512,둔촌푸르지오아파트사거리,155,70,225,37.5343756009,127.1449229185
25513,강일고등학교.강일리버파크7단지,72,12,84,37.5650288184,127.1779895218
25514,둔촌고앞,178,93,271,37.5316854362,127.1437301419
25516,구립둔촌어린이집,26,50,76,37.5300877341,127.1430346175
25517,고덕1동주민센터.두레근린공원,157,80,237,37.5581605018,127.151465352
25518,고덕역1번출구,53,241,294,37.5553179348,127.1531515358
25520,명일신동아아파트,271,56,327,37.552739,127.152717
25522,한산초등학교,96,40,136,37.527451917,127.1416277447
25523,상일동역3.4번출구,273,490,763,37.5570366996,127.1679754044
25524,한산중학교,80,99,179,37.5281885341,127.1389985407
25525,주양쇼핑,69,298,367,37.5521985598,127.1528990113
25526,고덕리엔파크1단지,53,28,81,37.5612429559,127.170520124
25527,둔촌역,91,160,251,37.528598,127.137631
25528,고덕역1번출구,532,90,622,37.5555055926,127.1533776217
25529,고덕1동주민센터.두레근린공원,14,157,171,37.5582760602,127.1517169476
25530,우리은행둔촌역지점.발리호텔,204,129,333,37.5290164166,127.1360979027
25532,둔촌청구아파트,166,38,204,37.5295051666,127.1342126479
25533,고덕중학교,33,87,120,37.5607702765,127.1610298468
25534,대순진리회,195,130,325,37.5303284009,127.1313345271
25535,농협둔촌동지점,148,204,352,37.5290882264,127.143696504
25536,성내2동주민센터.성내복지관,223,165,388,37.5311925076,127.1280943379
25537,고덕아이파크101동,278,27,305,37.5605725168,127.1559730955
25538,성내삼성아파트.공안과,154,124,278,37.5318998345,127.1256096517
25539,9호선중앙보훈병원역1번출구,163,814,977,37.5277928417,127.147509378
25540,성내주유소,41,241,282,37.5328991827,127.1221432471
25541,묘곡초교사거리,120,62,182,37.559319351,127.151627345
25542,선린초등학교,41,51,92,37.5288318609,127.145195025
25543,아남.대우아파트,171,143,314,37.5574978845,127.1445857174
25544,롯데캐슬아파트,83,44,127,37.5561042049,127.1444776533
25545,명일동국민은행.래미안솔베뉴,66,122,188,37.5537289168,127.1441672987
25546,명일역,99,232,331,37.5520472158,127.1439571157
25547,성덕고등학교,516,186,702,37.5507648497,127.1433061388
25549,천호우성아파트,340,185,525,37.5505952077,127.1397441084
25550,성내주유소,116,80,196,37.5327089263,127.1222640082
25551,약국앞,296,202,498,37.5500706967,127.1375044877
25552,성내삼성아파트.공안과,209,175,384,37.53165,127.126183
25553,강동농협,432,314,746,37.5480835452,127.1353709023
25554,성내2동주민센터.성내복지관,153,188,341,37.5310582873,127.1280545065
25556,대순진리회,100,199,299,37.5301455577,127.131262924
25557,고분다리,269,150,419,37.5426653669,127.1312860033
25558,둔촌청구아파트,76,151,227,37.5294985648,127.1336774558
25560,둔촌시장.발리호텔,236,237,473,37.5288209974,127.1359945857
25561,천호동로데오거리,21,338,359,37.540564881,127.1271982797
25562,서울.경기양돈농협,227,112,339,37.547634262,127.1334687776
25563,둔촌역,250,84,334,37.528562,127.137231
25565,브라운스톤,7,212,219,37.5490807055,127.130071564
25566,한산초등학교,63,155,218,37.527106,127.142588
25568,암사종합시장,7,604,611,37.549833,127.128379
25570,천호역5번출구,443,143,586,37.5377527162,127.1270531861
25571,암사역,74,57,131,37.5506330065,127.1278571069
25573,구립둔촌어린이집,47,93,140,37.530511,127.143354
25574,암사삼성.현대아파트,12,55,67,37.5535201618,127.1288699863
25575,둔촌고등학교,110,145,255,37.5317806918,127.1439441771
25576,천호우체국,185,33,218,37.5408597005,127.1253621434
25577,고덕주유소.선사초등학교,3,35,38,37.555382,127.129569
25578,둔촌푸르지오아파트사거리,115,215,330,37.5343357062,127.1450862778
25579,천호동로데오거리,201,54,255,37.5403621445,127.1271888823
25580,선사마을,1,23,24,37.557670789,127.1304452986
25581,길동은평교회,106,213,319,37.5364235286,127.1458326287
25582,천호시장,90,155,245,37.5406526302,127.1293711544
25583,서울암사동유적,1,18,19,37.5593681789,127.1311704207
25584,길동초등학교,126,217,343,37.5387294931,127.1465126841
25585,고분다리,210,400,610,37.5429343454,127.1316893468
25586,서원마을,66,42,108,37.563753054,127.1330896356
25587,신명초교입구교차로,90,195,285,37.5403287195,127.1469372022
25589,서울암사동유적,21,0,21,37.5593289013,127.1308364383
25591,강동농협,287,434,721,37.5484091555,127.1358971506
25592,선사마을,47,0,47,37.5572645099,127.1300088207
25593,고덕아이파크101동,26,210,236,37.560448,127.156037
25594,약국앞,211,285,496,37.5499147893,127.1375200461
25595,선사초등학교,36,10,46,37.5550594945,127.1291908257
25596,광문고.서울컨벤션고,200,28,228,37.5605,127.157554
25597,천호우성아파트,140,259,399,37.5503787701,127.1391291506
25601,고덕풍경채어바니티,80,39,119,37.563645,127.170216
25602,암사역,184,82,266,37.5509557782,127.1277593685
25604,고덕풍경채어바니티,3,63,66,37.563582,127.170017
25605,주원교회,10,0,10,37.565946,127.164756
25606,주원교회,0,21,21,37.565696,127.165133
25607,우진산전.디엠스퀘어,208,13,221,37.567118,127.160461
25608,에이스메디칼타워,9,39,48,37.56713,127.160906
25609,강동아이파크더리버.이케아,564,17,581,37.566649,127.158736
25610,지식산업센터,517,921,1438,37.5653235039,127.159940671
25611,온조대왕문화체육관,81,55,136,37.557835126,127.1565213227
25612,온조대왕문화체육관,29,88,117,37.5563795973,127.1568206916
25613,광문고.컨벤션고,12,128,140,37.559787,127.156966
25614,샘터배드민턴장,97,25,122,37.562061,127.156754
25615,샘터배드민턴장,4,53,57,37.56229,127.157098
25618,강동아이파크더리버.이케아,352,1073,1425,37.566966,127.158778
25643,성덕중고등학교,113,459,572,37.5506458538,127.1426910953
25654,천호초교입구사거리,174,435,609,37.5464912979,127.1342128515
25658,천호초교입구사거리,434,161,595,37.5458969151,127.1336463101
25659,천호3동주민센터,53,131,184,37.540876,127.129416
25666,암사종합시장,547,9,556,37.5496990461,127.1282504974
25674,명일동국민은행.래미안솔베뉴,66,76,142,37.553371595,127.1443598929
25675,브라운스톤,116,84,200,37.5488715672,127.1301481597
25678,삼익가든아파트,77,40,117,37.5463048142,127.1485399627
25679,삼익가든아파트,11,88,99,37.5461581277,127.1487789938
25680,둔촌신성미소지움아파트,57,22,79,37.526769824,127.1441700307
25681,둔촌신성미소지움아파트,11,68,79,37.5266617041,127.1441698227
25682,9호선중앙보훈병원역1번출구,843,187,1030,37.5279111948,127.1475394189
25722,상일초등학교,658,248,906,37.546426778,127.1715811881
25730,서울.경기양돈농협,124,154,278,37.5475443585,127.1332864085
25732,고덕래미안힐스테이트시니어센터,32,197,229,37.5592945402,127.1479430795
25733,고덕1동주민센터.고덕래미안힐스테이트,36,129,165,37.5587067757,127.1505497145
25736,고덕중학교,63,40,103,37.5606230267,127.1606412781
25740,상일동역5번출구.고덕아르테온,737,232,969,37.5568896432,127.168427776
25746,강일리버파크1단지.금화사,0,89,89,37.5670276893,127.1733772273
25749,강일리버파크6단지,0,7,7,37.5639305134,127.1754976862
25753,강일리버파크1단지정문,23,349,372,37.5680965321,127.1728698017
25760,가래여울,2,34,36,37.5765642585,127.1690128239
25761,강동리버스트4단지,26,0,26,37.5737736537,127.1719948336
25762,힐스테이트리슈빌강일503동,53,0,53,37.5730121616,127.176673894
25763,강동리버스트8단지,5,67,72,37.5725963295,127.1761086097
25764,강빛초.중학교,1,23,24,37.57415,127.1728
25990,암사삼성.현대아파트,90,40,130,37.553596538,127.1286195152
27071,의왕테크노파크,6,102,108,,
27137,고천파출소,233,81,314,,
28017,미사강변루나리움.17단지,286,22,308,,
28018,미사강변루나리움.17단지,13,208,221,,
28020,센트럴풍경채.동일하이빌.강동리엔9단지,4,17,21,,
28100,미사강변더샵센트럴포레.동원로얄듀크,118,43,161,,
28179,미사강변동원로얄듀크.고덕어반브릿지,47,16,63,,
28180,미사강변동원로얄듀크.고덕어반브릿지,9,28,37,,
28287,미사강변푸르지오.하우스디더레이크,32,229,261,,
28289,미사강변푸르지오.하우스디더레이크,278,27,305,,
28298,미사역사일가공원.센텀팰리스.하남고,462,117,579,,
28299,미사강변센트럴자이.20단지.하남고등학교,8,183,191,,
28439,미사강변더샵센트럴포레.동원로얄듀크,42,94,136,,
28461,미사강변도시베라체,446,25,471,,
28472,하남고등학교,168,18,186,,
28509,센트럴풍경채.동일하이빌.강동리엔9단지,16,13,29,,
28527,효죽동입구,83,63,146,,
28532,스타필드시티.위례지웰푸르지오.하남시위례도서관,510,341,851,,
28533,스타필드시티.위례지웰푸르지오.하남시위례도서관,327,446,773,,
28573,미사강변루나리움.강일리버5단지,89,4,93,,
28587,미사역사일가공원.동일하이빌.센텀팰리스,10,374,384,,
35001,고양시청,8,28,36,,
35002,고양시청,93,89,182,,
35003,양조장,23,34,57,,
35004,원릉역,19,28,47,,
35005,원릉역,28,23,51,,
35007,소만마을,500,332,832,,
35008,소만마을,518,638,1156,,
35009,고양시청.덕양구보건소,18,17,35,,
35010,고양시청.덕양구보건소,34,29,63,,
35011,양조장입구,17,29,46,,
35012,원당중학교,26,41,67,,
35013,원당중학교,46,32,78,,
35014,성사2동행정복지센터,25,66,91,,
35015,성사2동행정복지센터,46,30,76,,
35017,고양시청,24,12,36,,
35021,윗배다리,6,17,23,,
35023,윗배다리,4,10,14,,
35024,고양시청,54,101,155,,
35026,도래울2단지상가,144,155,299,,
35033,달걀부리마을,70,21,91,,
35034,원흥주유소,21,113,134,,
35035,흥도동주민센터,58,134,192,,
35039,원흥동,28,48,76,,
35040,원흥동,11,25,36,,
35041,가시골,29,58,87,,
35042,가시골,86,20,106,,
35043,훼릭스,1,9,10,,
35044,흥도동주민센터,1,9,10,,
35045,달걀부리마을,16,46,62,,
35046,훼릭스,2,2,4,,
35047,흥도동주민센터,5,4,9,,
35048,원흥주유소,38,33,71,,
35050,원흥도래울마을,824,411,1235,,
35051,원흥도래울마을,465,583,1048,,
35055,성사고등학교,74,30,104,,
35056,원당대림아파트,63,16,79,,
35061,명승세도나빌딩,86,11,97,,
35062,세창짜임아파트,97,10,107,,
35063,체육공원앞,10,3,13,,
35064,원당래미안아파트,41,68,109,,
35065,동양쇼핑.원당시장후문,30,102,132,,
35066,원당약국.원당시장정문,20,158,178,,
35067,신원당마을입구,312,397,709,,
35068,신원당마을입구,665,402,1067,,
35070,원당역,733,1065,1798,,
35071,원당역,757,530,1287,,
35072,신원당마을7단지,67,43,110,,
35073,신원당마을7단지,53,99,152,,
35103,삼송역,10,282,292,,
35112,삼송마을20단지,28,34,62,,
35117,삼송마을16.17단지,36,27,63,,
35120,삼송역,254,37,291,,
35121,세수동,25,17,42,,
35122,세수동,68,77,145,,
35123,동산고등학교,54,56,110,,
35124,서오릉입구,4,43,47,,
35125,서오릉입구,34,12,46,,
35126,고려분재연구원.금륜사앞,10,85,95,,
35127,고려분재연구원.금륜사앞,45,3,48,,
35128,서오릉길교차로,32,152,184,,
35129,서오릉길교차로,158,28,186,,
35130,용두2리,32,93,125,,
35131,용두2리,106,27,133,,
35132,부대앞,20,61,81,,
35133,부대앞,58,20,78,,
35134,용두사거리,20,109,129,,
35135,삼송테크노밸리,10,2,12,,
35136,삼송테크노밸리,0,5,5,,
35137,시계입구가게앞검문소,7,47,54,,
35138,용두사거리,89,32,121,,
35140,용두사거리,11,5,16,,
35145,동산마을22단지,94,195,289,,
35153,용두7통앞,7,73,80,,
35154,용두6통앞,9,51,60,,
35155,용두5통앞,15,38,53,,
35156,용두초등학교앞,4,83,87,,
35157,용두사거리,1,11,12,,
35158,삼송교,34,44,78,,
35159,동산동능모퉁이.한국지역난방공사,33,260,293,,
35160,동산동능모퉁이.한국지역난방공사,522,74,596,,
35161,용두5통앞,71,11,82,,
35162,삼송교,38,32,70,,
35163,용두초등학교앞,88,5,93,,
35164,시계입구가게앞검문소,33,26,59,,
35165,용두7통앞,53,6,59,,
35167,용두6통앞,51,10,61,,
35170,동산마을22단지,318,93,411,,
35171,동산고등학교,31,44,75,,
35173,용사촌입구.밥할머니공원앞,59,335,394,,
35174,용사촌입구,267,42,309,,
35175,큰골입구,124,37,161,,
35205,도래울마을1단지,6,0,6,,
35276,삼성당,12,16,28,,
35277,대곡역두산위브,139,141,280,,
35278,고촌역,15,42,57,,
35279,삼정그린코아더베스트.DMC디에트르한강,138,7,145,,
35280,DMC디에트르한강.삼정그린코아더베스트,6,141,147,,
35282,화훼단지,4,10,14,,
35283,화훼단지,3,4,7,,
35287,신주택,15,8,23,,
35289,신주택,4,19,23,,
35292,능곡초교,191,72,263,,
35296,대곡역두산위브,145,95,240,,
35297,삼성당다리,26,43,69,,
35298,삼성당,29,22,51,,
35299,능곡초등학교,93,229,322,,
35300,섬말다리,26,25,51,,
35301,일산화훼단지,7,7,14,,
35302,일산화훼단지,3,10,13,,
35303,섬말다리,26,28,54,,
35307,하늘빌딩,85,11,96,,
35308,으뜸로입구,14,196,210,,
35312,DMC리버파크자이,291,34,325,,
35313,DMC리버파크자이,24,213,237,,
35314,DMC리버시티자이,185,13,198,,
35315,DMC리버시티자이,24,168,192,,
35316,DMC자이더포레리버뷰,175,18,193,,
35317,DMC자이더포레리버뷰,33,76,109,,
35331,은평공영차고지,354,7,361,,
35344,능곡시장,122,94,216,,
35345,능곡역.능곡시장,228,200,428,,
35350,능곡전화국,23,200,223,,
35355,능곡전화국,54,21,75,,
35358,행신동삼거리.무원마을10단지,172,130,302,,
35360,행신SK뷰아파트,104,143,247,,
35361,토당초등학교.우창프라자,23,62,85,,
35362,토당초등학교.우창프라자,25,23,48,,
35365,무원고교,66,64,130,,
35366,행신동삼거리,66,42,108,,
35370,소만초등학교.소만마을8단지,69,53,122,,
35374,무원고교,55,77,132,,
35377,가라뫼.소만마을1단지,64,104,168,,
35380,가라뫼.한전앞,117,80,197,,
35385,명지병원.은빛마을5단지,110,224,334,,
35388,고양경찰서앞.고양어린이박물관앞,218,270,488,,
35389,고양경찰서앞.고양어린이박물관앞,89,104,193,,
35390,화정역.롯데마트,354,290,644,,
35391,별빛마을8단지.롯데마트,230,171,401,,
35393,달빛신안아파트.명지병원,187,95,282,,
35394,화정1동행정복지센터,134,130,264,,
35395,화정1동행정복지센터,283,109,392,,
35397,단독주택단지,187,111,298,,
35398,옥빛마을16단지,29,63,92,,
35402,단독주택단지,89,172,261,,
35414,양지말,2,6,8,,
35421,대덕동주민센터,21,193,214,,
35424,쌍굴입구,5,6,11,,
35425,쌍굴입구,8,7,15,,
35426,부대앞,7,7,14,,
35427,부대앞,2,9,11,,
35428,현천동마트,20,16,36,,
35429,현천동마트,14,14,28,,
35430,현천동난점,0,6,6,,
35431,현천동난점,2,2,4,,
35433,현천동,8,22,30,,
35434,현천동,16,6,22,,
35437,양지말,9,26,35,,
35438,양지말,6,0,6,,
35439,항공대학교,29,79,108,,
35446,대덕동주민센터,196,59,255,,
35447,덕은동입구,0,112,112,,
35448,덕은동입구,126,2,128,,
35449,덕은동종점,0,1,1,,
35450,덕은동종점,5,0,5,,
35451,양지말,2,7,9,,
35461,맨돌,28,23,51,,
35462,맨돌,24,20,44,,
35476,항공대학교,75,31,106,,
35477,용두초등학교입구.금륜사앞,2,1,3,,
35478,흥도동주민센터,51,115,166,,
35537,도래울2단지상가,150,94,244,,
35559,도래울마을1단지,0,5,5,,
35560,도래울마을2.3단지,214,77,291,,
35561,도래울마을2.3단지,120,196,316,,
35562,도래울마을5.6단지,295,112,407,,
35563,도래울마을5.6단지,152,250,402,,
35564,화랑교차로,14,3,17,,
35565,화랑교차로,2,10,12,,
35566,도래울마을6.7단지,73,17,90,,
35567,용두7통,19,9,28,,
35568,용두7통,7,26,33,,
35601,화정역.덕양구청,158,241,399,,
35602,덕양구청,155,170,325,,
35614,행주산성입구.행주내동,26,8,34,,
35615,행주산성입구.행주내동,17,38,55,,
35618,능곡화원,15,25,40,,
35619,능곡화원,3,20,23,,
35620,대곡역,344,434,778,,
35621,대곡역,524,312,836,,
35622,덕은초.덕양중학교,235,174,409,,
35623,덕은초.덕양중학교,215,170,385,,
35624,덕은동,108,180,288,,
35625,덕은동,267,196,463,,
35626,행신초등학교,601,774,1375,,
35627,서정마을,274,382,656,,
35628,화전파출소,123,45,168,,
35629,화전파출소,33,198,231,,
35630,화도교,24,61,85,,
35631,화도교,23,77,100,,
35632,서정마을,237,240,477,,
35633,행신동,480,606,1086,,
35634,행신동,491,495,986,,
35635,고양경찰서.토당청소년수련관,389,578,967,,
35636,고양경찰서.토당청소년수련관,713,647,1360,,
35637,행신초등학교,943,643,1586,,
35641,고양어울림누리.달빛동부아파트,72,80,152,,
35642,고양어울림누리.달빛동부아파트,88,96,184,,
35644,도래울마을7단지,107,10,117,,
35649,도래울마을6.7단지,23,101,124,,
35650,도래울마을7단지,34,127,161,,
35651,용두동,2,62,64,,
35655,덕은양묘장,1,6,7,,
35656,덕은양묘장,2,18,20,,
35657,현천동일신농장,0,2,2,,
35658,현천동일신농장,0,1,1,,
35660,영일자원,2,0,2,,
35661,영일자원,0,7,7,,
35674,스타필드고양,220,481,701,,
35686,능곡역,140,101,241,,
35687,고양중학교,171,92,263,,
35688,고양중학교,51,103,154,,
35689,고양동산초등학교,264,100,364,,
35690,고양동산초등학교,184,251,435,,
35693,원당초등학교입구,16,17,33,,
35694,원당초등학교입구,27,15,42,,
35711,스타필드고양,522,156,678,,
35715,화정역3호선,7,0,7,,
35720,주교동.원릉방앗간,17,5,22,,
35899,항공대학교동문,8,15,23,,
35900,민방위교육장,5,0,5,,
35938,햇빛마을21단지,28,0,28,,
35962,항공대학교동문,3,3,6,,
35994,햇빛마을21단지,0,11,11,,
35995,민방위교육장,0,5,5,,
35996,화정역4번출구,0,12,12,,
36018,신원아파트앞,18,88,106,,
36019,신원아파트,56,35,91,,
36020,탄현역,27,117,144,,
36021,탄현역,138,21,159,,
36022,진로아파트.경남아너스빌,56,109,165,,
36023,탄현마을3.5단지,8,83,91,,
36024,탄현큰마을.동성아파트,62,333,395,,
36025,탄현큰마을.동성아파트,341,48,389,,
36026,탄현마을6.7단지,58,43,101,,
36027,일산두산위브더제니스,88,41,129,,
36028,탄현서광아파트,245,50,295,,
36029,탄현동문아파트,30,146,176,,
36030,동문아파트,42,183,225,,
36031,홀트학교,37,29,66,,
36032,탄현2단지.삼익아파트,94,12,106,,
36033,일산동중학교,10,82,92,,
36034,일산중고교,53,83,136,,
36035,한뫼초교.일산중고교,111,60,171,,
36044,건영아파트,99,19,118,,
36045,일신삼익아파트,52,273,325,,
36046,탄현2지구.풍림아파트,31,132,163,,
36047,탄현마을6.7단지,46,37,83,,
36048,홀트학교,33,60,93,,
36049,동문태영아파트,267,88,355,,
36050,황룡초교,1,16,17,,
36051,황룡초교,30,0,30,,
36052,부영아파트,0,21,21,,
36053,경남아파트,10,0,10,,
36055,탄현효성주은아파트,212,45,257,,
36057,탄현2단지.삼익아파트,9,68,77,,
36058,상탄초교,76,18,94,,
36060,탄현동문아파트,20,130,150,,
36061,탄현동문아파트,194,26,220,,
36070,현대홈타운,27,242,269,,
36072,일산시장,526,144,670,,
36076,명문자동차학원,18,25,43,,
36082,일산시장,270,286,556,,
36085,북일산전화국.일산2동주민센터,152,133,285,,
36089,일산터미널,25,41,66,,
36090,일산시장,113,317,430,,
36091,일산시장,343,88,431,,
36094,북일산전화국.일산2동주민센터,127,129,256,,
36095,일산터미널,24,131,155,,
36099,산들대림아파트.롯데마트,245,107,352,,
36100,산들마을입구,103,241,344,,
36102,하늘마을2.6단지,59,117,176,,
36103,중산1단지,24,7,31,,
36104,일산복음병원.일산하이병원,276,193,469,,
36105,안곡중고교,203,154,357,,
36106,안곡중고교,191,82,273,,
36107,일산복음병원.일산하이병원,186,235,421,,
36108,한뫼도서관.명문자동차학원,34,21,55,,
36109,중산1단지,1,24,25,,
36112,하늘마을2.6단지,42,120,162,,
36118,중산마을10단지.동신아파트,65,13,78,,
36120,중산마을입구.쌍용아파트.실로암병원,46,6,52,,
36121,쌍용아파트.중산마을입구,7,51,58,,
36122,중산마을10단지.동신아파트,17,48,65,,
36123,일산정보산업고교,182,119,301,,
36124,후곡한양아파트,63,173,236,,
36127,일산3동주민센터,25,113,138,,
36128,후곡동성아파트,103,40,143,,
36129,후곡롯데아파트,145,91,236,,
36130,동부한신아파트,13,88,101,,
36131,일산3동주민센터,102,34,136,,
36132,신일중학교,72,83,155,,
36133,신일중학교.밤가시마을,48,55,103,,
36136,초가집.저동고교,87,39,126,,
36137,초가집.저동고교,21,75,96,,
36138,일산정보산업고교,121,121,242,,
36140,부대앞,64,88,152,,
36141,약산마을.애니골입구,79,133,212,,
36142,약산마을.애니골입구,79,89,168,,
36143,부대앞,103,85,188,,
36145,밤가시마을,59,137,196,,
36146,밤가시마을,129,44,173,,
36148,일산병원,150,84,234,,
36149,어린이교통공원,44,65,109,,
36150,어린이교통공원,29,23,52,,
36158,백석7블록,40,106,146,,
36160,백석동우체국,97,82,179,,
36168,일산병원,137,96,233,,
36174,법원공무원교육청,143,99,242,,
36175,백석역.고양종합터미널,26,96,122,,
36187,진로아파트.경남아너스빌,88,44,132,,
36190,백석고등학교,175,82,257,,
36199,백석초등학교,59,142,201,,
36207,국립암센터,140,222,362,,
36208,국립암센터,284,118,402,,
36211,마두1동주민센터,102,178,280,,
36212,마두1동주민센터,205,88,293,,
36213,정발고등학교,43,104,147,,
36214,정발고등학교,90,27,117,,
36226,백신중학교.이마트,133,188,321,,
36231,금계초등학교.이마트,175,160,335,,
36234,발산중학교,103,133,236,,
36245,발산중학교,84,169,253,,
36256,장성중학교.대진고등학교,79,0,79,,
36261,농수산물센타,18,117,135,,
36263,성저초등학교,9,0,9,,
36266,예비군훈련장.성저3.4단지,4,44,48,,
36268,성저공원.대화동주민센터,6,57,63,,
36269,성저공원.대화동주민센터,73,4,77,,
36272,농수산물센터,84,38,122,,
36273,장성중학교,4,45,49,,
36278,성저초등학교,0,7,7,,
36279,대진고등학교,1,51,52,,
36280,대진고등학교,108,1,109,,
36281,대화역,296,144,440,,
36293,청석궁.성석동감내,58,1,59,,
36294,상감천마을,35,1,36,,
36297,청석궁.성석동감내,0,36,36,,
36298,설문동,0,25,25,,
36299,설문동,21,0,21,,
36302,상감천마을,1,45,46,,
36303,철산아파트.탄현역앞,2,53,55,,
36313,서울도시가스,17,0,17,,
36325,서울도시가스,0,14,14,,
36330,송산3통,10,2,12,,
36339,덕이동행정복지센터사거리,16,26,42,,
36340,덕이동행정복지센터사거리,12,12,24,,
36341,덕이초등학교,3,20,23,,
36342,덕이초등학교,36,7,43,,
36343,송산3통,10,23,33,,
36348,철산아파트.탄현역앞,84,3,87,,
36349,가좌동종점,17,1,18,,
36350,동해운수,69,1,70,,
36351,대화동종점,0,112,112,,
36550,산들마을5단지,13,29,42,,
36551,일산역,3,119,122,,
36552,대우동양아파트,0,25,25,,
36601,대화역,254,279,533,,
36602,일산서부경찰서,1,13,14,,
36606,탄현큰마을.쌍용아파트,85,11,96,,
36607,탄현큰마을.쌍용아파트,5,83,88,,
36608,동국대병원사거리,310,245,555,,
36609,동국대병원사거리,277,238,515,,
36611,은행마을3단지.일산자이센트리지.일산자이더헤리티지,254,58,312,,
36612,일산자이센트리지.일산자이더헤리티지,125,250,375,,
36613,식사동,32,27,59,,
36614,식사3거리.식사공단,20,87,107,,
36615,식사오거리,21,31,52,,
36616,식사오거리,25,44,69,,
36617,탄현마을5.6단지,29,90,119,,
36618,현대홈타운,141,65,206,,
36637,농수산물도매시장후문,1,1,2,,
36638,농수산물도매시장후문,1,35,36,,
36640,부대앞,1,20,21,,
36641,중산마을2단지.해태쇼핑.코오롱,54,9,63,,
36642,중산마을2단지.해태쇼핑.코오롱,23,48,71,,
36644,덕이동문2차아파트,193,5,198,,
36645,덕이동문2차아파트,1,140,141,,
36653,우편집중국,16,99,115,,
36654,우편집중국,56,10,66,,
36656,두신마을,74,0,74,,
36657,두신마을,0,61,61,,
36658,덕이상가,45,1,46,,
36660,흰돌5단지.서안아파트,9,133,142,,
36661,흰돌마을.서안아파트,119,12,131,,
36662,한성아파트.중산마을8.9단지,33,5,38,,
36663,한성아파트.중산마을8.9단지,7,25,32,,
36664,일산동부경찰서,544,454,998,,
36665,일산동부경찰서,363,488,851,,
36666,백석동.요진와이시티,720,330,1050,,
36667,백석동.요진와이시티,438,753,1191,,
36682,안산공원,415,324,739,,
36683,백석역,213,296,509,,
36684,흰돌마을,58,98,156,,
36685,마두역,517,615,1132,,
36686,마두역,589,353,942,,
36687,강선마을,141,85,226,,
36688,강선마을,40,163,203,,
36690,문촌마을,56,161,217,,
36691,문촌마을,117,69,186,,
36692,일산서구청,28,118,146,,
36693,일산서구청.백병원,149,43,192,,
36694,일산동구청,589,563,1152,,
36695,일산동구청,567,688,1255,,
36696,호수마을,74,63,137,,
36699,주엽역,135,151,286,,
36700,주엽역,193,108,301,,
36701,알미공원,207,272,479,,
36702,만자고개,223,2,225,,
36704,백송고등학교.백송마을,22,2,24,,
36705,송포백송,6,146,152,,
36714,성재공단입구,0,37,37,,
36715,성재공단입구,13,1,14,,
36716,백석역.고양종합터미널,79,11,90,,
36734,고양예고입구,3,221,224,,
36735,고양예고입구,206,15,221,,
37001,관문체육공원.과천성당,166,452,618,,
37002,정부과천청사역11번출구.KT과천지사,827,837,1664,,
37003,과천10단지,124,294,418,,
37004,경기과천교육도서관.과천역7출구,216,493,709,,
37005,관문체육공원.과천성당,463,138,601,,
37006,정부과천청사역3번출구,1032,487,1519,,
37008,찬우물,331,181,512,,
37009,수자원공사.센트레빌아스테리움,340,385,725,,
37010,과천위버필드.래미안슈르,387,420,807,,
37012,찬우물,301,924,1225,,
37013,과천푸르지오라비엔오,1657,1099,2756,,
37014,과천지식정보타운,1253,1273,2526,,
37016,경기과천교육도서관.과천역6출구,298,131,429,,
37017,과천중앙공원.KT과천지사,728,378,1106,,
37018,정부과천청사역2번출구,578,1159,1737,,
37019,과천8.9단지,311,187,498,,
37024,주암동,27,130,157,,
37025,양지마을.환경사업소,84,61,145,,
37026,한내마을.환경사업소,65,127,192,,
37028,남태령고개,4,100,104,,
37029,남태령고개,24,35,59,,
37033,과천동주민센터,171,344,515,,
37034,과천동주민센터,335,137,472,,
37035,주암동,17,25,42,,
37037,정보과학도서관,336,264,600,,
37500,선바위역1번출구,3056,671,3727,,
37501,잔디마을,17,397,414,,
37502,선바위역2번출구,264,1844,2108,,
37503,안골,17,172,189,,
37504,안골,32,216,248,,
38001,철산교,165,70,235,,
38003,철산리버빌아파트,173,465,638,,
38006,광명초등학교,188,764,952,,
38008,광명사거리역7번출구,188,827,1015,,
38010,경기항공고등학교,136,134,270,,
38011,광명초등학교,269,242,511,,
38013,광명시청.한국폴리텍대학,102,140,242,,
38015,광명시청.한국폴리텍대학,186,160,346,,
38016,광명사거리역8번출구,2092,365,2457,,
38018,광명시장,316,247,563,,
38019,광명시청.한국폴리텍대학,103,96,199,,
38021,한진아파트,204,487,691,,
38023,광명시장,76,77,153,,
38025,광남새마을금고,17,221,238,,
38026,광명사거리역.한진아파트,535,267,802,,
38029,새마을시장,41,385,426,,
38031,광명남초등학교,142,223,365,,
38032,새마을시장,499,41,540,,
38034,광명호반써밋그랜드에비뉴1단지,31,262,293,,
38035,광명6동행정복지센터.명문고,7,148,155,,
38049,광명호반써밋그랜드에비뉴2단지,534,35,569,,
38051,명문고등학교.광남중학교,175,16,191,,
38052,광남중학교.광명교육청,30,155,185,,
38053,광남사거리.광명교육청,386,46,432,,
38056,영서전력소,0,51,51,,
38057,광명돔경륜장,7,19,26,,
38058,밤일로사거리,28,2,30,,
38059,원광명,1,62,63,,
38060,원광명,47,4,51,,
38065,광명북중고등학교,0,79,79,,
38066,철산1동주민센터,0,10,10,,
38067,세풍운수종점,11,3,14,,
38068,광복시장.철산두산위브아파트,50,161,211,,
38069,철산우성아파트,0,21,21,,
38071,철산현대아파트,59,127,186,,
38073,세풍운수종점,4,3,7,,
38075,철산우성아파트,1,60,61,,
38076,철산우성아파트,46,0,46,,
38078,광복시장.철산두산위브아파트,93,37,130,,
38079,철산리버빌아파트,295,271,566,,
38080,광명북중고등학교,171,1,172,,
38084,철산현대아파트,159,54,213,,
38085,모세로삼거리,38,145,183,,
38092,철산주공9단지,6,34,40,,
38093,현충탑입구.철산종합사회복지관,72,25,97,,
38094,현충탑입구.철산종합사회복지관,11,53,64,,
38095,철산우체국,160,311,471,,
38098,현충근린공원,37,191,228,,
38099,현충근린공원,108,5,113,,
38102,철산주공8단지,17,63,80,,
38104,철산13단지,222,86,308,,
38105,모세로삼거리,156,61,217,,
38107,철산역,223,502,725,,
38108,광명시민회관,710,340,1050,,
38110,광명경찰서,461,645,1106,,
38111,철산주공12단지,2,26,28,,
38112,철산푸르지오하늘채아파트,551,290,841,,
38113,광명성애병원,131,631,762,,
38114,광명성애병원,208,101,309,,
38115,광명경찰서,453,245,698,,
38116,철산래미안자이아파트,802,154,956,,
38118,광명사회체육센터,147,93,240,,
38119,철산주공12단지,56,137,193,,
38120,철산교앞,2,75,77,,
38122,철산센트럴푸르지오,194,475,669,,
38123,철산주공12단지,109,38,147,,
38125,철산역,505,230,735,,
38126,광성초교,157,60,217,,
38127,철산9단지우체국앞,279,75,354,,
38128,철산동13단지후문앞,132,29,161,,
38129,광명시청.광명시민회관,154,610,764,,
38131,경기항공고등학교,68,126,194,,
38133,광명우체국,16,455,471,,
38134,복지관운동장,397,115,512,,
38137,자동차경매장.가림초등학교,51,7,58,,
38140,광명이편한세상센트레빌아파트,87,494,581,,
38142,하안버스공영차고지,74,454,528,,
38144,광명시민체육관,520,108,628,,
38147,하안소방파출소,54,422,476,,
38150,하안주공8.13단지,37,198,235,,
38151,하안주공8.13단지,270,30,300,,
38154,가림중학교,50,15,65,,
38155,가림중학교,3,37,40,,
38160,광명농협,516,17,533,,
38161,하안소방파출소,530,15,545,,
38164,가림초등학교.자동차경매장,10,40,50,,
38166,광명시범공단,228,73,301,,
38167,광명시범공단,26,290,316,,
38169,광명농협,4,652,656,,
38173,신촌마을,218,669,887,,
38175,소하초중고등학교,70,295,365,,
38181,가리대.소하3단지.소하상업지구,164,388,552,,
38182,기아사거리,21,4,25,,
38188,기아자동차출하사무소,7,21,28,,
38190,소하초중고등학교,338,92,430,,
38192,수자원공사광명가압장,58,37,95,,
38193,가리대삼거리.소하상업지구,527,154,681,,
38194,가리대사거리.소하상업지구,54,56,110,,
38195,수자원공사광명가압장,175,132,307,,
38196,서면초.안서중.창의경영고,251,28,279,,
38198,창의경영고,6,55,61,,
38199,소하성당,1,53,54,,
38200,코스트코광명점,17,227,244,,
38202,창의경영고,34,30,64,,
38203,기아자동차후문.한소망교회,27,56,83,,
38204,소하성당,10,19,29,,
38206,서면초.안서중.창의경영고,54,307,361,,
38207,광명시여성비전센터,306,84,390,,
38209,KTX광명역3번출구,231,49,280,,
38211,호봉골,557,53,610,,
38213,무의공이순신장군묘,488,29,517,,
38215,광명역데시앙.일직동행정복지센터,128,15,143,,
38216,광명역써밋플레이스정문,116,3,119,,
38217,기아자동차후문.한소망교회,77,54,131,,
38218,소하2동행정복지센터.광명동굴길입구,578,207,785,,
38221,소하2동행정복지센터.광명동굴길입구,127,352,479,,
38222,광명시여성비전센터,87,470,557,,
38227,이케아.롯데아울렛.광명점,53,751,804,,
38229,원노온사,2,59,61,,
38230,가락골,1,66,67,,
38231,온신초등학교앞,0,133,133,,
38233,가락골,55,0,55,,
38234,원노온사,59,2,61,,
38235,온신초등학교,175,4,179,,
38236,원가학,13,60,73,,
38237,장절리,14,58,72,,
38238,장절리,35,8,43,,
38239,동창골,12,37,49,,
38240,동창골,29,7,36,,
38241,사들,4,20,24,,
38242,사들,34,14,48,,
38245,뒷골사거리,61,9,70,,
38246,원가학,85,17,102,,
38249,노온사동차고지,2,59,61,,
38250,아방리입구,1,139,140,,
38252,뒷골,14,61,75,,
38254,노온사동차고지,137,0,137,,
38255,철산교,44,124,168,,
38500,남부주유소,13,9,22,,
38501,대상APT,129,45,174,,
38502,천일택배앞,13,18,31,,
38503,하안주공12.14단지입구,321,9,330,,
38504,개봉한진APT후문,22,36,58,,
38505,진성학원앞,5,67,72,,
38506,기아대교,1,41,42,,
38507,도덕초등학교,14,49,63,,
38508,기아자동차출하장,0,31,31,,
38509,철산주공10단지,2,45,47,,
38510,기아자동차정문,1,31,32,,
38512,메모리얼파크,0,43,43,,
38514,기아자동차남문.광명역세권1단지,43,154,197,,
38516,성채안로입구삼거리,161,125,286,,
38518,광명역세권1단지후문,162,43,205,,
38520,메모리얼파크,0,2,2,,
38522,기아자동차정문,32,1,33,,
38523,하안주공13단지,66,418,484,,
38525,기아자동차출하장,10,1,11,,
38526,하안주공13단지상가,26,117,143,,
38527,기아대교,33,10,43,,
38535,현충근린공원,103,35,138,,
38536,철산주공8단지,35,10,45,,
38537,도덕초등학교,63,20,83,,
38538,광명국민체육센터,12,21,33,,
38608,광명공영차고지종점,0,136,136,,
38609,광명사거리역1번출구,332,587,919,,
38611,철산역.광명경찰서,805,184,989,,
38612,철산역.광명경찰서,164,457,621,,
38614,광명시민체육관,70,468,538,,
38616,광명우체국,779,22,801,,
38620,기형도문학관.황용사,178,65,243,,
38621,기형도문학관.황용사,3,67,70,,
38622,온신초등학교,93,9,102,,
38625,밤일마을,45,82,127,,
38626,하안버스공영차고지,537,7,544,,
38628,KTX광명역8번출구,60,248,308,,
38643,하안1동주민센터,103,488,591,,
38647,기아교차로,5,30,35,,
38648,기아자동차입구,2,10,12,,
38649,광명테크노파크,218,104,322,,
38650,소하7단지,49,70,119,,
38652,트리우스광명정문,243,96,339,,
38653,트리우스광명정문,118,306,424,,
38654,트리우스광명입구,73,30,103,,
38676,신촌마을,25,220,245,,
38677,소하단독필지,64,187,251,,
38678,소하6단지.광명노인회관,62,150,212,,
38695,신촌마을아파트2단지.광명노인회관,147,54,201,,
38696,신촌마을아파트,157,50,207,,
38697,신촌마을,856,318,1174,,
38698,광명국민체육센터,18,15,33,,
38775,영서전력소,19,2,21,,
39006,담터고개,5,211,216,,
39021,딸기원,51,37,88,,
39025,교문사거리,38,159,197,,
39026,딸기원,42,71,113,,
39028,교문사거리,114,41,155,,
39038,돌다리,287,177,464,,
39039,수택동농협,8,60,68,,
39040,수택동농협,84,12,96,,
39042,새마을금고.구리시장입구,60,200,260,,
39044,수택고교.SK신일.우남아파트,0,45,45,,
39045,돌다리,87,197,284,,
39046,검배사거리,100,22,122,,
39047,검배사거리,10,67,77,,
39049,새마을금고.구리시장입구,160,75,235,,
39050,남양시장.교문정형외과,17,80,97,,
39051,수택고교.SK신일.우남아파트,40,0,40,,
39053,태영데시앙,66,23,89,,
39054,동명빌라,2,25,27,,
39056,장자호수공원역5번출구.한성3차.구리고교,18,55,73,,
39057,장자호수공원역4번출구.LG원앙.한성아파트,196,8,204,,
39058,수평사거리.우림아파트,60,23,83,,
39059,럭키아파트,89,28,117,,
39060,장자호수공원역6번출구,83,44,127,,
39063,대림한숲아파트,63,26,89,,
39064,구리여중고,121,67,188,,
39066,구리여중고교,38,50,88,,
39070,신정형외과의원,3,51,54,,
39071,신정형외과의원,33,5,38,,
39072,수평사거리.우림아파트,12,78,90,,
39073,밀알교회.구리사회복지관,23,97,120,,
39074,밀알교회.구리사회복지관,133,30,163,,
39075,럭키아파트,28,104,132,,
39076,행정복지센터.새마을금고,42,98,140,,
39077,행정복지센터.새마을금고,173,58,231,,
39078,장자호수공원역3번출구.구리.한양아파트,23,94,117,,
39079,대림.하나아파트,20,87,107,,
39080,구리차고지,11,0,11,,
39081,벌말삼거리.상록아파트,29,4,33,,
39082,한일아파트,28,38,66,,
39083,동명빌라,25,2,27,,
39085,벌말삼거리.상록아파트,13,31,44,,
39086,삼성.e편한세상아파트,39,5,44,,
39087,삼성.e편한세상아파트,15,34,49,,
39088,구리차고지,0,3,3,,
39137,미리내마을입구,15,4,19,,
39138,담터입구,0,8,8,,
39439,양주역,14,1,15,,
39920,양주역,1,34,35,,
40002,군포중학교,112,279,391,,
40003,군포중학교,403,111,514,,
40006,군포1동행정복지센터.군포역,155,453,608,,
40008,군포역,320,139,459,,
40009,호계3동주민센터,265,34,299,,
40011,가구단지입구,70,269,339,,
40012,당동우체국,124,472,596,,
40016,유한양행,42,194,236,,
40023,군포보건소,188,8,196,,
40024,당동주공아파트,8,274,282,,
40025,삼성마을5단지,44,2,46,,
40027,당동주공아파트,201,34,235,,
40028,군포보건소,1,117,118,,
40029,군포보건소,52,1,53,,
40031,당동우체국,455,143,598,,
40032,군포초등학교,302,49,351,,
40034,삼성마을5단지,0,106,106,,
40037,군포초등학교,52,379,431,,
40045,군포시평생학습원,442,92,534,,
40046,복합화물터미널후문.가족센터,482,7,489,,
40048,군포도시공사.군포국민체육센터,6,233,239,,
40050,군포시평생학습원,109,376,485,,
40051,용호고등학교,45,317,362,,
40052,용호고등학교,462,17,479,,
40053,군포초등학교,145,19,164,,
40054,당동초등학교,15,132,147,,
40055,군포도시공사.군포국민체육센터,147,11,158,,
40058,산본고가도로,196,204,400,,
40060,금정역,442,1192,1634,,
40061,미도아파트.메트로병원,173,84,257,,
40062,산본고가도로,203,105,308,,
40064,산본1동,729,138,867,,
40065,산본1동,214,397,611,,
40067,삼성아파트입구,236,536,772,,
40068,산본시장,147,283,430,,
40069,산본1동입구,171,172,343,,
40070,금정역,1766,667,2433,,
40073,산본래미안아파트,398,148,546,,
40075,13단지아파트입구,152,257,409,,
40078,산본2동행정복지센터,239,82,321,,
40079,산본2동행정복지센터,21,133,154,,
40080,산본래미안,127,136,263,,
40081,산본래미안,92,90,182,,
40083,금정IC,49,194,243,,
40086,금정고가금정농협,303,65,368,,
40087,산본주유소,67,456,523,,
40088,신환아파트,244,49,293,,
40089,신환아파트,26,138,164,,
40090,금정역,194,790,984,,
40092,금정역,1382,338,1720,,
40096,금정가구거리,47,101,148,,
40097,금정가구거리,128,336,464,,
40098,11단지,219,56,275,,
40099,시민체육광장,105,15,120,,
40100,군포시청.산본역,415,67,482,,
40101,주공2단지,19,250,269,,
40102,주공1단지.무궁화아파트,391,53,444,,
40103,군포경찰서,8,190,198,,
40104,시민체육광장,4,146,150,,
40106,늘푸른노인복지관,49,292,341,,
40107,군포경찰서,189,28,217,,
40108,오금동주민센터.흥진고교,41,142,183,,
40110,5단지입구,6,218,224,,
40111,5단지입구,88,38,126,,
40113,흥진중학교,66,45,111,,
40117,오금동행정복지센터,230,52,282,,
40119,수리산역.5단지,64,190,254,,
40121,3단지.율곡아파트,21,175,196,,
40122,3단지.소월아파트.다산아파트,240,5,245,,
40125,군포소방서,50,87,137,,
40127,철쭉동산.철쭉공원,69,57,126,,
40130,극동아파트,13,303,316,,
40131,산본공업고등학교,223,156,379,,
40132,둔전초등학교,232,239,471,,
40133,둔전초등학교,558,126,684,,
40134,산본공업고등학교,312,226,538,,
40136,우방아파트,78,293,371,,
40137,군포문화예술회관,109,380,489,,
40139,군포시청.산본역,81,393,474,,
40140,엘림복지원,448,104,552,,
40141,군포문화예술회관,301,128,429,,
40142,남천병원.서울시남부기술교육원,96,287,383,,
40144,장미아파트,241,76,317,,
40145,도장중학교,39,70,109,,
40601,당동지하차도,508,56,564,,
40602,군포G샘병원,93,459,552,,
40608,금정IC,64,73,137,,
40609,수리산역,363,56,419,,
40615,군포공영차고지,0,121,121,,
40618,복합화물터미널후문.가족센터,8,530,538,,
40619,군포공영차고지,22,2,24,,
40620,금당터널입구,2,34,36,,
40621,금당터널입구,79,24,103,,
40622,느티울공원입구,3,140,143,,
41599,풍무역.트레이더스,11,3,14,,
41655,풍무푸르지오.풍무센트럴푸르지오,0,4,4,,
41658,서해2차아파트,0,12,12,,
41673,풍무홈플러스,44,0,44,,
41675,서해1차아파트,166,0,166,,
41677,서해2차아파트,67,0,67,,
41678,풍무푸르지오.풍무센트럴푸르지오,48,6,54,,
41683,풍무역.트레이더스,18,24,42,,
41685,서해1차아파트,0,17,17,,
41688,수행마을.홈플러스,0,6,6,,
42066,불암동,3,128,131,,
42067,202번종점,38,4,42,,
42068,202번종점,3,120,123,,
42069,불암동,100,3,103,,
42100,삼육대후문.논골.포레나별내,184,492,676,,
42101,삼육대후문.논골.포레나별내,676,100,776,,
42401,신안인스빌아파트,272,8,280,,
42402,신안인스빌아파트,32,365,397,,
42403,화접초등학교.별내고등학교,204,4,208,,
42404,화접초등학교.별내고등학교,10,148,158,,
42405,루이어닻별.별내스위첸아파트,84,26,110,,
42406,별내스위첸아파트.루이어닻별,8,72,80,,
42407,주을곡,114,87,201,,
42408,주을곡,50,115,165,,
42409,별사랑마을2-7단지,137,34,171,,
42410,별사랑마을2-7단지,36,104,140,,
42413,동익미라벨아파트,298,86,384,,
42414,동익미라벨아파트,141,313,454,,
42415,별내동주민센터앞.쌍용예가정문,224,47,271,,
42416,별내동주민센터앞.쌍용예가정문,64,242,306,,
42420,미리내마을4.2단지.한별초등학교,121,342,463,,
42421,별내리슈빌아파트,204,50,254,,
42422,별내리슈빌아파트,52,188,240,,
42425,효성해링턴코트,156,57,213,,
42445,효성해링턴코트,53,155,208,,
44001,옥길동마을회관,9,15,24,,
44002,옥길동,6,10,16,,
44003,옥길동마을회관,27,12,39,,
44006,옥길동,11,3,14,,
44007,제이드카운티1단지,9,213,222,,
44008,제이드카운티2단지.헤일라움,27,35,62,,
44009,옥길중.버들초등학교,28,27,55,,
44010,센트럴힐.옥길주민지원센터,66,34,100,,
44011,옥길브리즈힐후문,39,39,78,,
44012,브리즈힐.센트리뷰,72,22,94,,
44013,별빛마루도서관.소사경찰서.옥길동행정복지센터,229,8,237,,
44020,부천남부생태공원입구,2,35,37,,
44021,부천남부생태공원입구,14,5,19,,
45002,여월농업공원.여월휴먼시아4단지,7,23,30,,
45003,부천종합운동장역5번출구,54,124,178,,
45004,원종종합시장성곡사거리,184,277,461,,
45014,원종종합시장성곡사거리,144,99,243,,
45015,부천종합운동장역6번출구,182,64,246,,
45016,여월휴먼시아4단지,3,62,65,,
45023,원종역2번출구,359,249,608,,
45024,원종역3번출구,259,286,545,,
45028,서림아파트,165,142,307,,
45029,서림아파트,90,109,199,,
45039,고강사거리,150,194,344,,
45043,부강아파트,149,66,215,,
45044,수주도서관.고강선사유적공원,141,122,263,,
45045,수주도서관.고강선사유적공원,91,116,207,,
45046,고강사거리,297,146,443,,
45054,부강아파트,86,159,245,,
45064,도당사거리.북중학교,91,27,118,,
45067,도당사거리,16,21,37,,
45073,도당사거리.북중학교,57,129,186,,
45074,하나은행부천도당금융센터,51,69,120,,
45075,하나은행부천도당금융센터,43,33,76,,
45076,도당동행정복지센터,39,91,130,,
45078,부천북고.도당고,24,24,48,,
45079,여월중,39,39,78,,
45080,여월중,56,56,112,,
45200,성우아파트,22,16,38,,
45204,성우아파트,8,42,50,,
45281,양지초교.부안초교,77,68,145,,
45282,역곡고가입구,21,52,73,,
45283,역곡역남부,113,276,389,,
45284,역곡역남부,315,97,412,,
45285,역곡고가입구,57,16,73,,
45286,양지초교.부안초교,32,70,102,,
45604,서울농원,5,20,25,,
45605,서울농원,6,54,60,,
45623,부천우편집중국.부천실업고,115,112,227,,
45624,부천우편집중국.부천실업고,218,176,394,,
45627,오정동경인OBS방송국,94,120,214,,
45628,오정동경인OBS방송국,208,91,299,,
45631,오정구청입구.덕산고등학교,32,80,112,,
45632,오정구청입구.덕산고등학교,52,10,62,,
45635,내촌사거리,27,104,131,,
45636,내촌사거리,146,47,193,,
45639,여월휴먼시아1단지.까치울중학교,31,7,38,,
45640,여월휴먼시아1단지.까치울중학교,3,46,49,,
45641,오정경찰서.부천옹기박물관,19,6,25,,
46001,부천북초등학교,118,110,228,,
46004,부천북초등학교,154,96,250,,
46005,뉴대성병원.심곡천,121,132,253,,
46006,뉴대성병원.심곡천,162,136,298,,
46007,노마즈하우스.우리은행,120,170,290,,
46010,부천대학입구.KT부천지사,144,59,203,,
46015,당아래지하차도.산업인력공단,23,39,62,,
46016,춘의테크노파크단지앞,179,92,271,,
46017,춘의역,121,183,304,,
46018,춘의역,288,141,429,,
46019,춘의테크노파크단지앞,132,157,289,,
46020,춘의가구거리,118,92,210,,
46021,당아래지하차도.산업인력공단,31,32,63,,
46022,춘의가구거리,27,39,66,,
46026,도당사거리,26,40,66,,
46027,KT북부천지사.민방위교육장,32,61,93,,
46028,KT북부천지사.민방위교육장,75,71,146,,
46034,부천세무서,29,109,138,,
46035,약대초등학교입구,119,75,194,,
46036,농협신흥지점,38,53,91,,
46037,손가면옥,36,38,74,,
46039,송내역.반달공영주차장,0,103,103,,
46040,팰리스카운티.장말문예사거리,35,81,116,,
46041,부천북고.도당고,61,73,134,,
46042,도당동장미원입구,89,72,161,,
46043,손가면옥,46,58,104,,
46048,북부도서관,43,40,83,,
46049,도당동행정복지센터,75,27,102,,
46050,팰리스카운티.부천서초교입구,103,28,131,,
46051,팰리스카운티.부천서초교입구,44,142,186,,
46053,시민운동장.시민회관,46,117,163,,
46054,시민운동장,142,39,181,,
46055,부천대입구,42,88,130,,
46056,신중동역3번출구.롯데백화점.홈플러스중동지점,246,129,375,,
46057,부천시청.센트럴파크푸르지오,82,81,163,,
46058,부천시청.중동힐스테이트,110,108,218,,
46060,송내역A,277,2,279,,
46080,신중동역6번출구.중흥중학교,182,34,216,,
46081,부천세무서,60,23,83,,
46082,신중동역4번출구.롯데백화점.홈플러스중동지점,89,134,223,,
46083,신중동역5번출구.중흥중학교,54,195,249,,
46087,상동시장.중동역.부천여고,185,45,230,,
46089,송내초교.법원입구,116,16,132,,
46090,상동시장.중동역.부천여고,56,134,190,,
46092,법원.검찰청,59,3,62,,
46094,약대오거리.동부하이텍,67,33,100,,
46095,송내역,94,3,97,,
46096,법원.검찰청,3,73,76,,
46097,송내초교.법원입구,10,112,122,,
46101,자동차매매단지,1,52,53,,
46102,부인초교,0,19,19,,
46103,부인초교,26,0,26,,
46104,자동차매매단지,34,0,34,,
46105,상1동행정복지센터,0,82,82,,
46108,부인중학교,43,0,43,,
46109,부인중학교,1,34,35,,
46110,상1동행정복지센터,69,0,69,,
46121,부천상상거리,186,138,324,,
46601,상도중학교,11,94,105,,
46602,상도중학교,48,26,74,,
46603,꿈동산.사랑마을,21,143,164,,
46604,꿈동산.사랑마을,83,22,105,,
46605,복사골문화센터.부천시청소년센터,7,96,103,,
46606,복사골문화센타.반달마을,112,3,115,,
46607,한아름마을.반달마을,69,1,70,,
46611,반달마을.법원.검찰청,1,79,80,,
46612,법원.검찰청.복사골문화센타.반달마을,72,2,74,,
46615,복사골마을,53,70,123,,
46616,복사골마을,180,73,253,,
46617,그린타운상가.무지개마을,42,70,112,,
46618,그린타운상가.무지개마을,79,55,134,,
46619,중앙공원.미리내마을,23,51,74,,
46620,중앙공원.미리내마을,50,63,113,,
46621,상동시장,97,57,154,,
46622,상동시장,26,48,74,,
46633,상지초등학교,10,22,32,,
46634,상지초등학교,50,35,85,,
46687,북중학교,94,32,126,,
46725,목련마을,0,28,28,,
46726,목련마을,48,1,49,,
46727,오정경찰서.여월휴먼시아5단지,11,5,16,,
46728,오정경찰서.여월휴먼시아5단지,10,33,43,,
46729,한아름마을.반달마을,0,72,72,,
47011,파크타운.롯데아파트,387,20,407,,
47012,파크타운.양지마을,12,373,385,,
47017,푸른마을,704,83,787,,
47018,중앙공원.샛별마을우방아파트,14,220,234,,
47021,푸른마을,129,558,687,,
47022,중앙공원.샛별마을.라이프아파트,214,41,255,,
47023,중앙공원.샛별마을라이프아파트,20,120,140,,
47024,샛별마을.우방아파트,211,32,243,,
47025,한솔마을.LG아파트,13,146,159,,
47027,정자2동주민센터,115,10,125,,
47029,한솔마을.LG아파트,184,26,210,,
47033,주공7단지.한솔종합사회복지관,128,7,135,,
47034,한국통신이마트,5,55,60,,
47035,정자3동주민센터,6,201,207,,
47036,더샵분당파크리버.헬스케어혁신파크,220,60,280,,
47037,정든마을.우성아파트,23,203,226,,
47041,정자3동주민센터,316,44,360,,
47042,한진아파트,113,7,120,,
47043,정든마을.우성아파트,188,21,209,,
47044,더샵분당파크리버.헬스케어혁신파크,46,153,199,,
47045,분당도서관.계원예고.계원예술학교,7,62,69,,
47046,분당도서관.계원예고.이마트,136,11,147,,
47048,정자2동주민센터,11,99,110,,
47049,청솔마을.주공9단지.동아아파트,11,49,60,,
47051,한솔프라자,6,83,89,,
47052,미금역.농협.2001아울렛,3,151,154,,
47053,주공7단지앞,9,105,114,,
47054,효자촌,1087,100,1187,,
47055,양현보도육교,25,243,268,,
47057,까치마을건영빌라.구미도서관,3,15,18,,
47058,하얀마을,0,11,11,,
47059,양현보도육교,202,37,239,,
47063,서현중학교,48,157,205,,
47064,동아우성아파트.효자촌.시범단지,143,778,921,,
47065,서현중학교,226,53,279,,
47066,양현보도육교,42,28,70,,
47067,이매촌한신.서현역.AK프라자,95,72,167,,
47068,성남역,33,48,81,,
47069,성남역.이매고교.아름마을.효성선경아파트,48,11,59,,
47072,이매촌금강아파트.코오롱아파트.동부아파트,3,25,28,,
47073,성남아트센터.태원고교,7,10,17,,
47075,이매중학교,13,18,31,,
47077,성남아트센터.태원고교,3,14,17,,
47078,이매촌안말초교.성지아파트,4,11,15,,
47080,돌마고교,2,9,11,,
47081,송림고등학교.이매촌청구아파트.동신아파트,2,3,5,,
47082,매송중학교.풍림아파트,33,15,48,,
47083,이매역,2,9,11,,
47084,송림고교.이매촌성지아파트.청구아파트,6,6,12,,
47087,농업기술센터.진흥.동신APT.이매동주민센터,8,2,10,,
47088,이매촌삼성아파트,39,27,66,,
47092,삼환아파트,13,25,38,,
47093,상공회의소,11,21,32,,
47094,매송중학교.풍림아파트,23,34,57,,
47105,이매촌한신.서현역.AK프라자,540,140,680,,
47115,야탑역.고속버스터미널,117,227,344,,
47116,야탑역.종합버스터미널,111,22,133,,
47125,하탑초교.탑마을진덕아파트,21,21,42,,
47131,쌍용아파트,6,9,15,,
47132,경남아너스빌,23,19,42,,
47140,하탑초교.탑마을3차아파트,9,25,34,,
47148,하얀마을.그랜드빌.벽산빌라,21,3,24,,
47149,미금초등학교,2,62,64,,
47150,미금초등학교,41,8,49,,
47154,대원사거리.까치마을,96,22,118,,
47155,오리초등학교,103,8,111,,
47156,하얀마을.그랜드빌.벽산빌라,0,108,108,,
47157,대우.롯데아파트상가,212,7,219,,
47159,오리초등학교,8,39,47,,
47160,신원아파트,9,123,132,,
47162,낙생농협.오리역,0,62,62,,
47163,LG아파트.무지개마을사거리.신한아파트,194,2,196,,
47164,까치마을.건영빌라.2001아울렛,11,3,14,,
47165,미금역,193,8,201,,
47166,무지개마을.건영아파트,4,244,248,,
47167,성우스타우스앞,44,0,44,,
47168,신한아파트,3,60,63,,
47170,주공4단지,370,3,373,,
47172,구미동차고지,0,14,14,,
47623,분당구청입구.수내역,249,68,317,,
47624,분당구청입구.수내역,57,329,386,,
47626,농수산물센터,0,43,43,,
47631,성남역.백현마을2단지,169,54,223,,
47632,백현마을1단지,130,118,248,,
47633,낙생육교,235,1381,1616,,
47634,백현마을4단지,32,124,156,,
47635,성남역.백현마을3단지,12,79,91,,
47636,야탑2동주민센터.차병원,62,69,131,,
47637,야탑2동주민센터.차병원,36,22,58,,
47638,낙생육교,1009,331,1340,,
47639,야탑역.종합버스터미널,204,60,264,,
48003,단대오거리역.종점,981,499,1480,,
48005,단대오거리역.세이브존,587,1044,1631,,
48011,삼성생명.한국사회적기업진흥원,444,648,1092,,
48015,성남역.이매고교.아름마을.효성선경아파트,41,30,71,,
48016,성남우체국,364,258,622,,
48017,신흥역.종합시장,514,337,851,,
48018,성남수정경찰서앞,24,51,75,,
48019,가천대역.가천대학교,1163,622,1785,,
48020,수진리고개.태평고개,403,626,1029,,
48021,성남수정경찰서,524,421,945,,
48023,수진리고개.태평고개,663,402,1065,,
48024,통계청.태평역,635,1029,1664,,
48027,통계청.태평역,1231,917,2148,,
48028,성남시의료원.신흥1동행정복지센터,1247,1209,2456,,
48030,성남시의료원.신흥1동행정복지센터,888,774,1662,,
48031,중앙시장,775,858,1633,,
48032,중앙시장.농협,802,806,1608,,
48041,모란고개,19,94,113,,
48042,모란고개,55,33,88,,
48046,금광시장,74,15,89,,
48048,남한산성입구역.법원검찰청,130,261,391,,
48049,단대동행정복지센터.성남만남지역자활센터,101,43,144,,
48053,남한산성입구,212,158,370,,
48054,을지대학교,117,59,176,,
48055,을지대학교.생활관,253,66,319,,
48056,상원초등학교,238,158,396,,
48057,은행시장.남한산성시장,305,123,428,,
48058,복정동주민센터,532,540,1072,,
48059,복우물.웃말입구,236,340,576,,
48065,동서울대학교,394,438,832,,
48066,동서울대학교,495,475,970,,
48067,복우물.웃말입구,404,429,833,,
48068,복정동주민센터,303,513,816,,
48069,가천대역.가천대학교,611,769,1380,,
48070,복정초등학교,602,352,954,,
48073,남위례역.성남여성인력개발센터,45,403,448,,
48076,오야동.신촌동주민센터,25,6,31,,
48077,공군아파트,8,11,19,,
48078,신촌동앞,24,5,29,,
48079,신촌동앞,9,23,32,,
48080,효성고등학교,35,3,38,,
48081,효성고등학교,7,28,35,,
48082,오야동.신촌동주민센터,2,22,24,,
48083,공군아파트,23,3,26,,
48085,등자리,3,0,3,,
48087,고등동행정복지센터.판교밸리자이아파트,84,17,101,,
48088,등자리,0,2,2,,
48089,고등동행정복지센터.판교밸리자이아파트,37,83,120,,
48091,고등119안전센터,14,21,35,,
48092,공군부대제2정문.면회실,13,2,15,,
48234,청계산옛골,187,173,360,,
48372,한화오벨리스크,247,55,302,,
48373,청계산옛골,2,1,3,,
48376,위례센트럴자이정문,34,159,193,,
48388,남위례역.창곡교차로,212,49,261,,
48389,남위례역.창곡교차로,10,87,97,,
48449,텔레칩스,0,42,42,,
48451,판교이노베이션랩,0,33,33,,
48454,스마트모빌리티실증허브,0,3,3,,
48466,기업성장센터,0,35,35,,
48600,남한산성입구,20,41,61,,
48601,위례119안전센터.위례포레스트부영,28,167,195,,
48602,위례119안전센터.위례포레스트부영,29,7,36,,
48603,남위례역.복정지구,291,13,304,,
48604,양지근린공원,2,17,19,,
48605,여수대교,0,1,1,,
48606,고등119안전센터,11,31,42,,
48607,시흥동농협창고,8,4,12,,
48608,여수대교,1,3,4,,
48609,시흥동농협창고,3,10,13,,
48610,민속마을닭죽촌,27,68,95,,
48611,민속마을.선경아파트,40,53,93,,
48612,시흥동주민센터,3,3,6,,
48613,시흥동주민센터,5,2,7,,
48617,복정고등학교.복정지구,113,23,136,,
48618,복정고등학교.복정지구,23,99,122,,
48619,위례서일로마을입구,106,54,160,,
48620,위례서일로마을입구,16,36,52,,
48621,위례자이,6,62,68,,
48622,위례자이,82,17,99,,
48623,한국폴리텍대학,46,88,134,,
48624,한국폴리텍대학,29,37,66,,
48625,위례자이정문,15,206,221,,
48626,위례중앙중학교,192,17,209,,
48627,양지근린공원,1,11,12,,
48629,성남시위례동행정복지센터.위례아트리버푸르지오,93,314,407,,
48630,성남시위례동행정복지센터.위례보미리즌빌,322,99,421,,
48631,위례35단지아파트,229,315,544,,
48632,위례35단지아파트,346,177,523,,
48637,공군부대제2정문.면회실,4,7,11,,
48640,래미안위례.위례고운초등학교앞,173,215,388,,
48641,래미안위례.위례고운초등학교앞,206,76,282,,
48656,성남수정새마을금고.한국사회적기업진흥원,768,518,1286,,
48685,위례래미안이편한세상.힐스테이트위례,119,65,184,,
48686,한국군사문제연구원,77,153,230,,
48850,기업성장센터,42,0,42,,
48851,벤처타운,17,0,17,,
48952,벤처타운,9,0,9,,
48967,벤처타운,16,0,16,,
49001,모란역,179,63,242,,
49002,제일아파트.현대아파트.중원도서관,27,53,80,,
49003,중원구청,64,154,218,,
49004,성일중고.성일정보고.동광중고,289,158,447,,
49006,성남종합운동장.성남동행정복지센터,134,203,337,,
49007,성호시장,31,101,132,,
49012,성호시장,112,66,178,,
49013,성일중고.성일정보고.동광중고,221,186,407,,
49014,성남종합운동장.성남동행정복지센터,126,124,250,,
49015,중원구청,248,102,350,,
49016,현대아파트.중원도서관,105,35,140,,
49017,성호시장입구.단대리약국,85,90,175,,
49018,단대리약국,122,147,269,,
49020,상대원고개,326,98,424,,
49021,신흥역.종합시장,381,633,1014,,
49023,성남우체국,140,313,453,,
49026,남한산성입구역.법원검찰청,401,107,508,,
49036,금광시장,25,83,108,,
49040,단대동행정복지센터.성남만남지역자활센터,47,79,126,,
49042,을지대학교,62,173,235,,
49044,상원초교.성남중앙병원,75,223,298,,
49046,은행시장.남한산성시장,156,392,548,,
49047,남한산성입구.양지파출소,70,83,153,,
49048,대원사거리,81,418,499,,
49049,공단오거리.공단주유소,3,246,249,,
49052,대원터널앞사거리,390,65,455,,
49059,스타타워.동방렌탈,363,3,366,,
49060,스타타워.동방렌탈,1,274,275,,
49061,보통골동양공업사,49,316,365,,
49062,보통골동양공업사,181,0,181,,
49063,공단오거리.공단주유소,263,9,272,,
49064,상대원1동주민센터앞,33,142,175,,
49065,공단본부.샤니,21,250,271,,
49066,고려당사거리,207,7,214,,
49067,고려당사거리,3,221,224,,
49068,공단본부.샤니,262,34,296,,
49069,상대원1동주민센터,662,79,741,,
49070,상대원고개,29,426,455,,
49071,상대원시장,21,246,267,,
49073,상대원시장,322,74,396,,
49074,성남시청전면,77,20,97,,
49075,아튼빌아파트후문.성남방송고,34,152,186,,
49076,대하초등학교.중원청소년수련관,76,55,131,,
49077,대상델리하임,22,79,101,,
49078,영성중학교.하대원동주민센터,19,110,129,,
49079,성남자이아파트,81,22,103,,
49083,아튼빌아파트.중원청소년수련관,40,82,122,,
49085,영성중학교.하대원동주민센터,245,168,413,,
49086,아튼빌후문,137,42,179,,
49089,상대원차고지,107,61,168,,
49090,상대원차고지,0,1,1,,
49176,별내상업지구,121,23,144,,
49410,별내역아이파크스위트,28,21,49,,
49416,신일유토빌아파트.신안인스빌아파트후문,3,240,243,,
49417,신일유토빌아파트.신안인스빌아파트후문,203,5,208,,
49418,쌍용예가.미리내마을4-4단지,224,140,364,,
49419,미리내마을4-4단지.쌍용예가,140,192,332,,
49420,별내동주민센터입구.우미린아파트,25,90,115,,
49421,별내동주민센터입구.우미린아파트,77,3,80,,
49424,별빛마을3-6단지.별내자이더스타,104,3,107,,
49425,별빛마을3-6단지.별내자이더스타,0,150,150,,
49435,포스코더샵아파트.별사랑마을2-9,221,48,269,,
49436,포스코더샵아파트.별사랑마을2-9,57,150,207,,
49447,별내역2번.3번.5번출구.광역환승센터,217,307,524,,
49448,별내역4번출구.이마트,579,167,746,,
49450,미리내마을4.2단지.한별초등학교,491,117,608,,
49535,힐스테이트별내역.별내자이더스타,17,25,42,,
49536,힐스테이트별내역.별내자이더스타,20,88,108,,
49602,성남시청전면,24,132,156,,
49604,동부.코오롱아파트,12,87,99,,
49606,모란차량기지앞,4,3,7,,
49607,성남시청후문,3,0,3,,
49608,을지대학교.생활관,81,170,251,,
49680,하대원시장,13,73,86,,
49893,별빛마을3단지.신안인스빌정문,160,5,165,,
49894,별빛마을3단지.신안인스빌정문,5,96,101,,
56001,삼성래미안아파트,465,396,861,,
56004,비산롯데캐슬,255,326,581,,
56005,비산농협,123,293,416,,
56006,비산사거리.이마트,721,334,1055,,
56007,비산사거리.이마트,612,785,1397,,
56009,미륭아파트,159,194,353,,
56010,대림아파트,151,171,322,,
56011,삼호아파트.평촌우리병원,375,246,621,,
56012,행복마을아파트,0,267,267,,
56013,삼호아파트.평촌우리병원,39,46,85,,
56014,종합운동장수영장.비산동교회,937,5,942,,
56015,종합운동장,381,45,426,,
56016,종합운동장,71,64,135,,
56017,군인아파트앞,0,139,139,,
56018,인라인경기장,214,2,216,,
56019,안양비산동종점,0,61,61,,
56020,종합운동장,69,102,171,,
56021,종합운동장,63,701,764,,
56028,종합운동장정문,3,477,480,,
56029,관양중학교,132,167,299,,
56030,수촌마을,137,132,269,,
56031,수촌마을,132,136,268,,
56032,관양중학교,149,91,240,,
56033,중촌마을,95,93,188,,
56034,중촌마을,67,142,209,,
56035,인덕원역8번출구,402,284,686,,
56036,부림마을,36,65,101,,
56039,인덕원역3번출구,1294,1634,2928,,
56043,인덕원초교.삼성아파트,352,1154,1506,,
56044,인덕원사거리.인덕원역,2709,1772,4481,,
56045,인덕원역4호선.인덕원성당,83,149,232,,
56046,부림마을,69,121,190,,
56052,민백마을,477,376,853,,
56056,민백마을,281,449,730,,
56058,농수산물시장.포일단지입구,263,510,773,,
56062,미도아파트.메트로병원,158,123,281,,
56070,호계사거리,339,147,486,,
56071,평촌센텀퍼스트,129,63,192,,
56073,안양남초등학교,391,789,1180,,
56074,덕고개사거리,154,303,457,,
56076,삼신아파트,103,135,238,,
56077,삼신아파트,74,71,145,,
56078,서안이노빌아파트.평촌어바인퍼스트,360,283,643,,
56079,평촌어바인퍼스트아파트,317,233,550,,
56506,비산로제비앙,160,57,217,,
56507,비산화성파크드림,25,238,263,,
56574,대림대학,186,38,224,,
56575,대림대학,44,200,244,,
56601,평촌센텀퍼스트,31,188,219,,
56602,호계사거리,101,196,297,,
56603,한성병원.민방위교육장,111,438,549,,
56604,호계구삼거리,35,221,256,,
56608,동양월드타워,399,187,586,,
57001,대동문고.댕리단길,1335,856,2191,,
57002,안양1번가안양역,815,1034,1849,,
57003,남부시장,846,850,1696,,
57005,안양예술공원,567,368,935,,
57006,안양예술공원지하도,87,149,236,,
57008,안양여중고,362,569,931,,
57009,안양여중고,444,461,905,,
57010,신협,592,560,1152,,
57014,안양예술공원지하도,107,151,258,,
57015,삼성아파트,430,308,738,,
57017,만안초교,566,416,982,,
57019,삼성.세림아파트,350,411,761,,
57022,안양중앙시장,1011,945,1956,,
57023,안양시외버스정류소.교보생명.댕리단길,798,1468,2266,,
57024,우체국사거리.안양초교.중화한방병원,338,203,541,,
57025,우체국사거리.안양초교.중화한방병원,53,132,185,,
57029,서안양우체국,443,709,1152,,
57030,서안양우체국,494,812,1306,,
57033,농림축산검역본부,401,608,1009,,
57034,만안구청,376,543,919,,
57035,농림축산검역본부,850,465,1315,,
57037,만안구청,716,433,1149,,
57039,명학초교,142,267,409,,
57042,진흥아파트,269,242,511,,
57043,햇빛마을23단지,3,0,3,,
57045,선진운수원당차고지.원신4통입구,562,349,911,,
57046,명학초교,96,143,239,,
57047,성결대.안양아트센터.명학역,711,549,1260,,
57048,관악역,377,415,792,,
57050,한마음선원.관악역이안아파트,101,104,205,,
57051,안양예술공원,320,419,739,,
57055,관악역,754,715,1469,,
57061,석수체육공원.자동차학원,38,107,145,,
57062,석수체육공원.자동차학원,77,77,154,,
57065,관악역,76,118,194,,
57066,석수시장.석수현대아파트,552,473,1025,,
57069,안양대교,571,306,877,,
57070,농협.KT석수지점,244,390,634,,
57071,관악역,65,170,235,,
57072,안양대교앞,326,623,949,,
57074,석수현대아파트,266,274,540,,
57132,양명고.양명여고.대우아파트,52,87,139,,
57133,양명고.양명여고.대우아파트,81,93,174,,
57134,관악장애인종합복지관,1,12,13,,
57135,장애인복지회관,15,25,40,,
57136,장애인복지회관후문,58,37,95,,
57137,석수지구대,81,155,236,,
57138,안양예술공원입구.아르테자이후문,154,115,269,,
57254,햇빛마을24단지,0,5,5,,
57507,선진운수원당차고지.원신4통입구,0,7,7,,
57602,경인교육대학교,489,543,1032,,
57604,대림.LG아파트,511,270,781,,
57605,대림.LG아파트,503,721,1224,,
59625,LG트윈하우스,46,0,46,,
60001,고천.의왕시청,214,266,480,,
60003,고천.의왕시청,34,36,70,,
60008,서해그랑블,236,56,292,,
60009,신안아파트.글로벌도서관,135,313,448,,
60011,오전동주민센터,127,62,189,,
60012,가구단지입구,172,58,230,,
60013,오전동주민센터,30,108,138,,
60014,의왕지구대.글로벌도서관,339,112,451,,
60015,샘마을.대안중학교,195,353,548,,
60017,덕고개사거리,330,143,473,,
60019,농수산물시장.포일단지입구,439,351,790,,
60020,안양남초등학교,844,428,1272,,
60021,샘마을.대안중학교,525,246,771,,
60101,월암차고지,71,1,72,,
60102,월암차고지,1,40,41,,
60103,잿말.왕송호수공원,16,0,16,,
60104,잿말.왕송호수공원,0,35,35,,
60105,월암교,6,0,6,,
60106,월암교,1,6,7,,
60107,월암IC.월암동,7,0,7,,
60108,월암IC.월암동,0,8,8,,
60109,도룡마을,2,1,3,,
60110,도룡마을,0,5,5,,
60111,의왕고등학교,102,20,122,,
60112,의왕고등학교,4,213,217,,
60113,부곡복지회관,191,12,203,,
60114,부곡복지회관,8,213,221,,
60115,창말,72,26,98,,
60118,컨테이너기지,4,29,33,,
60119,교동,21,8,29,,
60120,교동,5,29,34,,
60121,재활용센타,3,9,12,,
60122,재활용센타,3,10,13,,
60123,중앙도서관,9,55,64,,
60124,중앙도서관,34,14,48,,
60125,의왕보건소,234,161,395,,
60126,의왕보건소,165,212,377,,
60127,부곡체육공원,56,9,65,,
60128,부곡체육공원,0,29,29,,
60129,장안마을,468,21,489,,
60130,장안마을,15,308,323,,
61016,e편한세상신곡파크비스타,177,49,226,,
61017,e편한세상신곡파크비스타,44,201,245,,
61018,아일랜드캐슬,6,16,22,,
61048,쌍암사입구,108,214,322,,
61049,장암우성아파트.장암주공2단지,60,565,625,,
61050,장암주공2단지.장암우성아파트,407,78,485,,
61051,쌍암사입구,62,172,234,,
61052,장암역.석림사입구,150,83,233,,
61053,장암역.석림사입구,79,636,715,,
61054,아일랜드캐슬,0,11,11,,
61060,도봉차량기지앞,13,34,47,,
61061,도봉차량기지앞,19,19,38,,
61063,한일유앤아이아파트,76,140,216,,
61064,신곡동신일아파트,222,60,282,,
61065,신곡현대아파트,48,78,126,,
61066,신곡현대아파트,230,58,288,,
61067,신곡지하차도,64,68,132,,
61068,신곡1동행정복지센터.신곡1동우체국,56,28,84,,
61069,동신현대.한일삼익아파트,145,10,155,,
61070,신곡현대아파트,74,11,85,,
61071,장암주공5단지.한국.풍림아파트,200,732,932,,
61072,의암교회,77,193,270,,
61073,서해아파트,297,337,634,,
61074,장암주공5단지앞,775,137,912,,
61075,의암교회앞,178,150,328,,
61076,신곡지하차도,15,58,73,,
61077,서해아파트,165,142,307,,
61078,은하수아파트,27,171,198,,
61079,굿모닝마트,138,18,156,,
61080,은하수아파트,135,7,142,,
61081,신명아파트백병원앞,163,116,279,,
61083,추동아파트,15,193,208,,
61084,신성벽산아파트앞,74,107,181,,
61085,동국대학교사범부속.영석고등학교,32,54,86,,
61086,송산주공4단지,72,38,110,,
61087,청구아파트,15,116,131,,
61088,민락주공2단지,123,30,153,,
61093,산들마을아파트,98,31,129,,
61094,신안아파트남문,145,48,193,,
61095,민락중학교,72,38,110,,
61096,민락중학교,12,55,67,,
61097,세아.보광.건영아파트앞,143,47,190,,
61101,민락교,4,0,4,,
61102,정음마을고산2단지.고산종합사회복지관,22,0,22,,
61105,고산대방노블랜드아파트,27,0,27,,
61106,고산대광로제비앙.고산센트레빌아파트,28,0,28,,
61107,고산더라피니엘.고산수자인디에스티지1단지,25,0,25,,
61108,고산수자인디에스티지.아트포레,38,0,38,,
61109,고산동.빼뻘,3,8,11,,
61110,현대힐스테이트아파트,5,0,5,,
61111,의정부법원.검찰청입구,12,0,12,,
61114,가능동우체국,14,0,14,,
61115,흥선광장,10,0,10,,
61116,흥선브라운스톤.더샵파크에비뉴아파트,44,1,45,,
61117,안골,47,1,48,,
61118,안골,0,29,29,,
61119,흥선브라운스톤.더샵파크에비뉴아파트,0,15,15,,
61121,금강펜테리움아파트,93,75,168,,
61122,낙양물사랑공원앞,104,129,233,,
61123,낙양물사랑공원앞,153,177,330,,
61124,부용마을3단지아파트,24,94,118,,
61126,의정부민락BRT정류소앞,144,32,176,,
61129,흥선광장,0,6,6,,
61131,구306보충대,172,69,241,,
61132,가능1동새마을금고,0,2,2,,
61133,의정부법원.검찰청입구,0,1,1,,
61134,신안아파트남문,98,105,203,,
61135,만가대.솔뫼중학교,117,75,192,,
61136,고산동.빼뻘,0,1,1,,
61137,고산수자인디에스티지.아트포레,0,8,8,,
61138,고산더라피니엘.고산수자인디에스티지1단지,0,6,6,,
61139,고산센트레빌.고산대광로제비앙아파트,0,3,3,,
61140,고산대방노블랜드아파트,0,3,3,,
61141,정음마을고산2단지.고산종합사회복지관,0,3,3,,
61142,민락교,0,2,2,,
61143,훈민초교.고산리슈빌포레,10,0,10,,
61144,고산지식산업센터,3,1,4,,
61145,고산지식산업센터,0,7,7,,
61146,훈민초교.고산리슈빌포레,0,5,5,,
61147,구306보충대,52,142,194,,
61148,동국대사법부속.영석고등학교,58,51,109,,
61149,마음의숲노인복지센터,14,0,14,,
61150,의정부서부새마을금고,0,2,2,,
61163,산들마을아파트,23,102,125,,
61164,민락주공2단지,23,164,187,,
61165,청구아파트,111,27,138,,
61166,송산1동주민센터,17,133,150,,
61167,만가대.솔뫼중학교,141,115,256,,
61176,송산1동주민센터앞,145,49,194,,
61500,수락리버시티2단지정문,296,388,684,,
61501,수락리버시티1단지후문,139,60,199,,
61502,수락리버시티1단지후문,15,66,81,,
61504,수락리버시티1단지정문,348,115,463,,
61604,다락원.서울도솔학교앞,12,35,47,,
61605,다락원.서울도솔학교앞,46,215,261,,
61608,민락엘레트19단지후문,0,33,33,,
61612,송양중학교,51,44,95,,
61613,송양중학교,90,65,155,,
61614,양지마을8단지,10,121,131,,
61615,양지마을8단지,187,10,197,,
61616,송양초등학교.송산3동행정복지센터,48,0,48,,
61617,송양초.민락센트럴17단지.송산3동행정복지센터,5,111,116,,
61618,양지마을후문입구,55,8,63,,
61619,용암마을입구,5,82,87,,
61620,용암마을16단지,252,15,267,,
61621,민락센트럴아파트.용암마을15단지,4,180,184,,
61622,무지랭이약수터.코스트코,161,2,163,,
61623,무지랭이약수터.코스트코,0,89,89,,
61624,송양고등학교,6,251,257,,
61625,송양고등학교,273,34,307,,
63101,초롱꽃마을10.11.12.13단지,0,13,13,,
63102,초롱꽃마을4.9단지,0,6,6,,
63103,초롱꽃마을6.7단지,0,8,8,,
63107,두일초등학교,0,4,4,,
63109,책향기마을10단지11단지,0,16,16,,
63208,동편마을입구,32,52,84,,
63638,책향기마을10단지11단지,18,0,18,,
63639,두일초등학교,4,0,4,,
63640,초롱꽃마을6.7단지,16,0,16,,
63641,초롱꽃마을4.9단지,8,0,8,,
63642,초롱꽃마을10.11.12.13단지,11,0,11,,
68107,옥정마을16단지.e편한세상18단지,0,12,12,,
68110,옥정상가주택.대방노블랜드12단지,1,7,8,,
68115,제일풍경채레이크시티.율정마을13단지,0,7,7,,
68116,율정마을7.8단지,0,3,3,,
68128,대방신도아파트,0,1,1,,
68129,고읍주공4단지.건강보험양주지사,2,5,7,,
68131,율정마을7.8단지,7,0,7,,
68136,제일풍경채레이크시티.율정마을13단지,44,0,44,,
68140,옥정상가주택.대방노블랜드12단지,19,0,19,,
68141,연푸른초교.한신더휴.e편한세상19단지,31,1,32,,
68142,덕현초교.덕고개,6,1,7,,
68143,덕현초교.덕고개,0,1,1,,
68144,고읍주공4단지.건강보험양주지사,5,0,5,,
68149,대방신도아파트,7,1,8,,
77101,한신더휴,31,0,31,,
77102,신안2차.반도4차,14,0,14,,
77103,이주택지.상록.경남아파트,8,0,8,,
77104,동원.다원중,9,0,9,,
77105,베라체아파트,31,0,31,,
77106,예솔초.호반2차.대원2차,23,0,23,,
77107,동원.다원중,0,12,12,,
77108,상록.경남아파트.이주택지,0,13,13,,
77109,반도4차.동탄4동복지센터,0,3,3,,
77110,센트럴푸르지오.호반베르디움2차,0,1,1,,
77111,청목초.신안1차,0,3,3,,
77112,동원로얄듀크2차.목동초,0,6,6,,
77113,힐스테이트.호반5차,0,10,10,,
78103,오포베르빌아파트,8,0,8,,
78104,수레실.오포롯데캐슬,12,0,12,,
78105,용상골현대아파트,5,0,5,,
78106,신현동행정복지센터,10,0,10,,
78107,현대모닝사이드1차아파트.새마을입구.신현리,16,0,16,,
78108,태재고개,20,1,21,,
78109,능평119안전센터,1,0,1,,
78110,광명초등학교,1,0,1,,
78111,태재고개,0,17,17,,
78112,현대모닝사이드1차아파트.새마을입구.신현리,0,7,7,,
78113,신현동행정복지센터,0,1,1,,
78114,광명초등학교,0,4,4,,
78115,능평119안전센터,0,4,4,,
78121,용상골현대아파트,0,1,1,,
78122,수레실전원교회.오포롯데캐슬,0,10,10,,
78123,오포베르빌아파트,0,12,12,,
~,상암차고지,4845,3695,8540,,
